revid	title	toclevel	index	indexInverse	bytes	date	titlesNumber	main category	second category
539478	Neurological Effects	1	0	6	0	24/12/02 06:25	6	effects	neutral
539478	Long Term Effects	2	0	6	0	24/12/02 06:25	6	effects	neutral
852042	Neurological Effects	1	0	7	0	25/03/03 16:38	7	effects	neutral
852042	Other Effects	1	0	7	0	25/03/03 16:38	7	effects	neutral
852042	Long Term Effects	2	0	7	0	25/03/03 16:38	7	effects	neutral
1365356	Effects	1	0	9	0	24/08/03 00:43	9	effects	neutral
1365356	Neurological Effects	2	0	9	0	24/08/03 00:43	9	effects	neutral
1365356	Long Term Effects	2	0	9	0	24/08/03 00:43	9	effects	neutral
1365356	Systemic Effects	2	0	9	0	24/08/03 00:43	9	effects	neutral
4711851	Effects	1	4	9	13	18/07/04 17:04	13	effects	neutral
4711851	Neurological Effects	2	5	8	1509	18/07/04 17:04	13	effects	neutral
4711851	Long Term Effects	2	7	6	1864	18/07/04 17:04	13	effects	neutral
4711851	Systemic Effects	2	6	7	1185	18/07/04 17:04	13	effects	neutral
4711851	Safer use	1	10	3	394	18/07/04 17:04	13	safety	positive
4848352	Effects	1	4	8	13	26/07/04 03:30	12	effects	neutral
4848352	Neurological Effects	2	5	7	1509	26/07/04 03:30	12	effects	neutral
4848352	Long Term Effects	2	7	5	1864	26/07/04 03:30	12	effects	neutral
4848352	Systemic Effects	2	6	6	935	26/07/04 03:30	12	effects	neutral
4870566	Effects	1	4	9	13	26/07/04 05:02	13	effects	neutral
4870566	Safety	1	10	3	968	26/07/04 05:02	13	safety	neutral
4870566	Neurological Effects	2	5	8	1509	26/07/04 05:02	13	effects	neutral
4870566	Long Term Effects	2	7	6	1864	26/07/04 05:02	13	effects	neutral
4870566	Systemic Effects	2	6	7	935	26/07/04 05:02	13	effects	neutral
6297804	Effects	1	4	9	13	02/10/04 21:09	13	effects	neutral
6297804	Neurological effects	2	5	8	1569	02/10/04 21:09	13	effects	neutral
6297804	Systemic effects	2	6	7	938	02/10/04 21:09	13	effects	neutral
6297804	Long-term effects	2	7	6	1864	02/10/04 21:09	13	effects	neutral
6297804	Safety	1	10	3	1264	02/10/04 21:09	13	safety	neutral
12822144	Effects	1	4	13	12	26/04/05 02:29	17	effects	neutral
12822144	Neurological effects	2	5	12	1883	26/04/05 02:29	17	effects	neutral
12822144	Systemic effects	2	7	10	336	26/04/05 02:29	17	effects	neutral
12822144	Long-term effects	2	6	11	3651	26/04/05 02:29	17	effects	neutral
12822144	Safety	1	11	6	1451	26/04/05 02:29	17	safety	neutral
12822144	Medical use	2	10	7	584	26/04/05 02:29	17	uses	positive
13735147	Effects	1	5	14	12	12/05/05 21:49	19	effects	neutral
13735147	Other short-term effects	2	7	12	1431	12/05/05 21:49	19	effects	neutral
13735147	Neurological effects	2	6	13	631	12/05/05 21:49	19	effects	neutral
13735147	Systemic effects	2	9	10	336	12/05/05 21:49	19	effects	neutral
13735147	Long-term effects	2	8	11	3651	12/05/05 21:49	19	effects	neutral
13735147	Safety	1	13	6	1451	12/05/05 21:49	19	safety	neutral
13735147	Medical use	2	12	7	657	12/05/05 21:49	19	uses	positive
28268652	Systemic effects	1	1	10	337	14/11/05 04:31	11	effects	neutral
28268652	Safety	1	5	6	1732	14/11/05 04:31	11	safety	neutral
28268652	Medical use	2	4	7	676	14/11/05 04:31	11	uses	positive
28271461	Effects	1	5	14	12	14/11/05 05:09	19	effects	neutral
28271461	Other short-term effects	2	7	12	1427	14/11/05 05:09	19	effects	neutral
28271461	Neurological effects	2	6	13	651	14/11/05 05:09	19	effects	neutral
28271461	Systemic effects	2	9	10	337	14/11/05 05:09	19	effects	neutral
28271461	Long-term effects	2	8	11	5043	14/11/05 05:09	19	effects	neutral
28271461	Safety	1	13	6	1732	14/11/05 05:09	19	safety	neutral
28271461	Medical use	2	12	7	676	14/11/05 05:09	19	uses	positive
33618142	Effects	1	6	14	12	02/01/06 18:11	20	effects	neutral
33618142	Other short-term effects	2	8	12	1190	02/01/06 18:11	20	effects	neutral
33618142	Systemic effects	2	10	10	368	02/01/06 18:11	20	effects	neutral
33618142	Long-term effects	2	9	11	4810	02/01/06 18:11	20	effects	neutral
33618142	Safety	1	14	6	1450	02/01/06 18:11	20	safety	neutral
33618142	Medical use	2	13	7	676	02/01/06 18:11	20	uses	positive
35622575	Safety	1	8	6	1450	18/01/06 02:01	14	safety	neutral
35622575	Medical use	2	7	7	676	18/01/06 02:01	14	uses	positive
35622600	Effects	1	6	14	12	18/01/06 02:02	20	effects	neutral
35622600	Other short-term effects	2	8	12	1190	18/01/06 02:02	20	effects	neutral
35622600	Systemic effects	2	10	10	368	18/01/06 02:02	20	effects	neutral
35622600	Long-term effects	2	9	11	4810	18/01/06 02:02	20	effects	neutral
35622600	Safety	1	14	6	1450	18/01/06 02:02	20	safety	neutral
35622600	Medical use	2	13	7	676	18/01/06 02:02	20	uses	positive
44710199	Effects	1	6	13	12	20/03/06 21:07	19	effects	neutral
44710199	Other short-term effects	2	8	11	1396	20/03/06 21:07	19	effects	neutral
44710199	Systemic effects	2	9	10	886	20/03/06 21:07	19	effects	neutral
44710199	Safety	1	13	6	2002	20/03/06 21:07	19	safety	neutral
44710199	Medical use	2	12	7	676	20/03/06 21:07	19	uses	positive
44710278	Effects	1	6	14	12	20/03/06 21:08	20	effects	neutral
44710278	Other short-term effects	2	8	12	1394	20/03/06 21:08	20	effects	neutral
44710278	Systemic effects	2	10	10	886	20/03/06 21:08	20	effects	neutral
44710278	Long-term effects	2	9	11	4837	20/03/06 21:08	20	effects	neutral
44710278	Safety	1	14	6	2002	20/03/06 21:08	20	safety	neutral
44710278	Medical use	2	13	7	676	20/03/06 21:08	20	uses	positive
49372594	Effects	1	6	14	12	21/04/06 00:46	20	effects	neutral
49372594	Other short-term effects	2	8	12	1396	21/04/06 00:46	20	effects	neutral
49372594	Systemic effects	2	10	10	854	21/04/06 00:46	20	effects	neutral
49372594	Safety	1	14	6	2002	21/04/06 00:46	20	safety	neutral
49372594	Medical use	2	13	7	676	21/04/06 00:46	20	uses	positive
49372619	Effects	1	6	14	12	21/04/06 00:47	20	effects	neutral
49372619	Other short-term effects	2	8	12	1396	21/04/06 00:47	20	effects	neutral
49372619	Systemic effects	2	10	10	854	21/04/06 00:47	20	effects	neutral
49372619	Long-term effects	2	9	11	8646	21/04/06 00:47	20	effects	neutral
49372619	Safety	1	14	6	2002	21/04/06 00:47	20	safety	neutral
49372619	Medical use	2	13	7	676	21/04/06 00:47	20	uses	positive
51850037	Effects	1	4	15	13	06/05/06 17:00	19	effects	neutral
51850037	Other short-term effects	2	7	12	1397	06/05/06 17:00	19	effects	neutral
51850037	Systemic effects	2	9	10	915	06/05/06 17:00	19	effects	neutral
51850037	Long-term effects	2	8	11	8649	06/05/06 17:00	19	effects	neutral
51850037	Safety	1	13	6	2010	06/05/06 17:00	19	safety	neutral
51850037	Medical use	2	12	7	676	06/05/06 17:00	19	uses	positive
51850037	Positive Effects that Users Seek	2	5	14	1177	06/05/06 17:00	19	effects	positive
51961631	Effects	1	4	15	13	07/05/06 10:12	19	effects	neutral
51961631	Other short-term effects	2	7	12	1397	07/05/06 10:12	19	effects	neutral
51961631	Systemic effects	2	9	10	915	07/05/06 10:12	19	effects	neutral
51961631	Long-term effects	2	8	11	9239	07/05/06 10:12	19	effects	neutral
51961631	Safety	1	13	6	2010	07/05/06 10:12	19	safety	neutral
51961631	Medical use	2	12	7	676	07/05/06 10:12	19	uses	positive
51961631	Positive effects sought by users	2	5	14	1177	07/05/06 10:12	19	effects	positive
59315933	Effects	1	4	16	12	18/06/06 19:33	20	effects	neutral
59315933	Other short-term effects	2	8	12	1674	18/06/06 19:33	20	effects	neutral
59315933	Systemic effects	2	10	10	1354	18/06/06 19:33	20	effects	neutral
59315933	Long-term effects	2	9	11	9233	18/06/06 19:33	20	effects	neutral
59315933	Medical use	2	13	7	676	18/06/06 19:33	20	uses	positive
59315933	Positive effects sought by users	2	5	15	1496	18/06/06 19:33	20	effects	positive
59315933	Safety and contradictions	1	14	6	2164	18/06/06 19:33	20	safety	neutral
60348132	Effects	1	4	17	12	24/06/06 15:49	21	effects	neutral
60348132	Subjective effects	2	8	13	1171	24/06/06 15:49	21	effects	neutral
60348132	Other short-term effects	2	9	12	3386	24/06/06 15:49	21	effects	neutral
60348132	Systemic effects	2	11	10	1354	24/06/06 15:49	21	effects	neutral
60348132	Long-term effects	2	10	11	8541	24/06/06 15:49	21	effects	neutral
60348132	Medical use	2	14	7	848	24/06/06 15:49	21	uses	positive
60348132	Positive effects sought by users	2	5	16	1444	24/06/06 15:49	21	effects	positive
60348132	Safety and contradictions	1	15	6	2219	24/06/06 15:49	21	safety	neutral
60348246	Effects	1	4	16	13	24/06/06 15:49	20	effects	neutral
60348246	Subjective effects	2	7	13	1171	24/06/06 15:49	20	effects	neutral
60348246	Other short-term effects	2	8	12	3386	24/06/06 15:49	20	effects	neutral
60348246	Systemic effects	2	10	10	1354	24/06/06 15:49	20	effects	neutral
60348246	Long-term effects	2	9	11	8541	24/06/06 15:49	20	effects	neutral
60348246	Medical use	2	13	7	848	24/06/06 15:49	20	uses	positive
60348246	Safety and contradictions	1	14	6	2219	24/06/06 15:49	20	safety	neutral
60348246	Acute Neurochemical Effects	2	6	14	872	24/06/06 15:49	20	effects	neutral
60349229	Effects	1	4	16	13	24/06/06 15:57	20	effects	neutral
60349229	Short-term neurochemical effects	2	6	14	877	24/06/06 15:57	20	effects	neutral
60349229	Subjective effects	2	7	13	1072	24/06/06 15:57	20	effects	neutral
60349229	Other short-term effects	2	8	12	668	24/06/06 15:57	20	effects	neutral
60349229	Long-term adverse effects	2	10	10	8548	24/06/06 15:57	20	effects	negative
60349229	Medical use	2	13	7	848	24/06/06 15:57	20	uses	positive
60349229	Safety and contradictions	1	14	6	2219	24/06/06 15:57	20	safety	neutral
60349229	Acute toxic (dangerous) effects	2	9	11	3563	24/06/06 15:57	20	effects	negative
60350024	Effects	1	4	16	13	24/06/06 16:03	20	effects	neutral
60350024	Short-term neurochemical effects	2	6	14	877	24/06/06 16:03	20	effects	neutral
60350024	Subjective effects	2	7	13	1072	24/06/06 16:03	20	effects	neutral
60350024	Other short-term effects	2	8	12	668	24/06/06 16:03	20	effects	neutral
60350024	Long-term adverse effects	2	10	10	8548	24/06/06 16:03	20	effects	negative
60350024	Medical use and clinical studies	2	13	7	869	24/06/06 16:03	20	uses	positive
60350024	Safety and contradictions	1	14	6	2375	24/06/06 16:03	20	safety	neutral
60350024	Acute toxic (dangerous) effects	2	9	11	3563	24/06/06 16:03	20	effects	negative
61606045	Effects	1	4	17	13	01/07/06 23:16	21	effects	neutral
61606045	Short-term neurochemical effects	2	6	15	877	01/07/06 23:16	21	effects	neutral
61606045	Subjective effects	2	7	14	1051	01/07/06 23:16	21	effects	neutral
61606045	Other short-term effects	2	8	13	668	01/07/06 23:16	21	effects	neutral
61606045	Addiction and Tolerance	2	10	11	524	01/07/06 23:16	21	effects	negative
61606045	Long-term adverse effects	2	11	10	8548	01/07/06 23:16	21	effects	negative
61606045	Medical use and clinical studies	2	14	7	869	01/07/06 23:16	21	uses	positive
61606045	Safety and contradictions	1	15	6	2375	01/07/06 23:16	21	safety	neutral
61606045	Acute toxic (dangerous) effects	2	9	12	3563	01/07/06 23:16	21	effects	negative
63811692	Effects	1	4	17	12	14/07/06 17:12	21	effects	neutral
63811692	Short-term neurochemical effects	2	6	15	869	14/07/06 17:12	21	effects	neutral
63811692	Subjective effects	2	7	14	1051	14/07/06 17:12	21	effects	neutral
63811692	Other short-term effects	2	8	13	780	14/07/06 17:12	21	effects	neutral
63811692	Addiction and Tolerance	2	10	11	1299	14/07/06 17:12	21	effects	negative
63811692	Long-term adverse effects	2	11	10	8548	14/07/06 17:12	21	effects	negative
63811692	Medical use and clinical studies	2	14	7	869	14/07/06 17:12	21	uses	positive
63811692	Safety and contraindications	1	15	6	2378	14/07/06 17:12	21	safety	neutral
63811692	Acute toxic (dangerous) effects	2	9	12	3562	14/07/06 17:12	21	effects	negative
63987291	Effects	1	4	17	12	15/07/06 18:19	21	effects	neutral
63987291	Short-term neurochemical effects	2	6	15	869	15/07/06 18:19	21	effects	neutral
63987291	Subjective effects	2	7	14	1051	15/07/06 18:19	21	effects	neutral
63987291	Other short-term effects	2	8	13	780	15/07/06 18:19	21	effects	neutral
63987291	Addiction and Tolerance	2	10	11	10714	15/07/06 18:19	21	effects	negative
63987291	Medical use and clinical studies	2	13	8	869	15/07/06 18:19	21	uses	positive
63987291	Safety and contraindications	1	14	7	2378	15/07/06 18:19	21	safety	neutral
63987291	Acute toxic (dangerous) effects	2	9	12	3562	15/07/06 18:19	21	effects	negative
64000969	Effects	1	4	18	12	15/07/06 19:48	22	effects	neutral
64000969	Short-term neurochemical effects	2	6	16	869	15/07/06 19:48	22	effects	neutral
64000969	Subjective effects	2	7	15	1051	15/07/06 19:48	22	effects	neutral
64000969	Other short-term effects	2	8	14	780	15/07/06 19:48	22	effects	neutral
64000969	Addiction and Tolerance	2	10	12	1299	15/07/06 19:48	22	effects	negative
64000969	Long-term adverse effects	2	11	11	9355	15/07/06 19:48	22	effects	negative
64000969	Medical use and clinical studies	2	14	8	869	15/07/06 19:48	22	uses	positive
64000969	Safety and contraindications	1	15	7	2378	15/07/06 19:48	22	safety	neutral
64000969	Acute toxic (dangerous) effects	2	9	13	3562	15/07/06 19:48	22	effects	negative
66680160	Effects	1	4	17	12	30/07/06 13:15	21	effects	neutral
66680160	Short-term neurochemical effects	2	6	15	894	30/07/06 13:15	21	effects	neutral
66680160	Subjective effects	2	7	14	1051	30/07/06 13:15	21	effects	neutral
66680160	Other short-term effects	2	8	13	4430	30/07/06 13:15	21	effects	neutral
66680160	Addiction and Tolerance	2	9	12	1302	30/07/06 13:15	21	effects	negative
66680160	Long-term adverse effects	2	10	11	9335	30/07/06 13:15	21	effects	negative
66680160	Medical use and clinical studies	2	13	8	869	30/07/06 13:15	21	uses	positive
66680160	Safety and contraindications	1	14	7	2378	30/07/06 13:15	21	safety	neutral
66683631	Effects	1	4	18	12	30/07/06 13:53	22	effects	neutral
66683631	Short-term neurochemical effects	2	6	16	894	30/07/06 13:53	22	effects	neutral
66683631	Subjective effects	2	7	15	1051	30/07/06 13:53	22	effects	neutral
66683631	Other short-term effects	2	8	14	815	30/07/06 13:53	22	effects	neutral
66683631	Acute toxic/dangerous effects	2	9	13	3590	30/07/06 13:53	22	effects	negative
66683631	Addiction and Tolerance	2	10	12	1302	30/07/06 13:53	22	effects	negative
66683631	Long-term adverse effects	2	11	11	9335	30/07/06 13:53	22	effects	negative
66683631	Medical use and clinical studies	2	14	8	869	30/07/06 13:53	22	uses	positive
66683631	Safety and contraindications	1	15	7	2378	30/07/06 13:53	22	safety	neutral
69644415	Effects	1	4	17	12	14/08/06 19:39	21	effects	neutral
69644415	Short-term neurochemical effects	2	6	15	903	14/08/06 19:39	21	effects	neutral
69644415	Other short-term effects	2	7	14	779	14/08/06 19:39	21	effects	neutral
69644415	Acute toxic/dangerous effects	2	8	13	4042	14/08/06 19:39	21	effects	negative
69644415	Addiction and Tolerance	2	9	12	1302	14/08/06 19:39	21	effects	negative
69644415	Long-term adverse effects	2	10	11	8713	14/08/06 19:39	21	effects	negative
69644415	Medical use and clinical studies	2	13	8	869	14/08/06 19:39	21	uses	positive
69644415	Safety and contraindications	1	14	7	2378	14/08/06 19:39	21	safety	neutral
69645872	Effects	1	4	18	12	14/08/06 19:47	22	effects	neutral
69645872	Short-term neurochemical effects	2	6	16	894	14/08/06 19:47	22	effects	neutral
69645872	Subjective effects	2	7	15	1039	14/08/06 19:47	22	effects	neutral
69645872	Other short-term effects	2	8	14	779	14/08/06 19:47	22	effects	neutral
69645872	Acute toxic/dangerous effects	2	9	13	4042	14/08/06 19:47	22	effects	negative
69645872	Addiction and Tolerance	2	10	12	1302	14/08/06 19:47	22	effects	negative
69645872	Long-term adverse effects	2	11	11	9103	14/08/06 19:47	22	effects	negative
69645872	Medical use and clinical studies	2	14	8	869	14/08/06 19:47	22	uses	positive
69645872	Safety and contraindications	1	15	7	2378	14/08/06 19:47	22	safety	neutral
75797589	Medical use and clinical studies	2	5	8	869	15/09/06 00:29	13	uses	positive
75797589	Safety and contraindications	1	6	7	2466	15/09/06 00:29	13	safety	neutral
75797595	Effects	1	4	18	12	15/09/06 00:29	22	effects	neutral
75797595	Short-term neurochemical effects	2	6	16	894	15/09/06 00:29	22	effects	neutral
75797595	Subjective effects	2	7	15	1039	15/09/06 00:29	22	effects	neutral
75797595	Other short-term effects	2	8	14	228	15/09/06 00:29	22	effects	neutral
75797595	Acute toxic/dangerous effects	2	9	13	4563	15/09/06 00:29	22	effects	negative
75797595	Addiction and Tolerance	2	10	12	1302	15/09/06 00:29	22	effects	negative
75797595	Long-term adverse effects	2	11	11	9963	15/09/06 00:29	22	effects	negative
75797595	Medical use and clinical studies	2	14	8	869	15/09/06 00:29	22	uses	positive
75797595	Safety and contraindications	1	15	7	2466	15/09/06 00:29	22	safety	neutral
81955375	Effects	1	4	17	12	17/10/06 07:43	21	effects	neutral
81955375	Short-term neurochemical effects	2	6	15	2168	17/10/06 07:43	21	effects	neutral
81955375	Other short-term effects	2	7	14	274	17/10/06 07:43	21	effects	neutral
81955375	Acute toxic/dangerous effects	2	8	13	4581	17/10/06 07:43	21	effects	negative
81955375	Addiction and Tolerance	2	9	12	1392	17/10/06 07:43	21	effects	negative
81955375	Long-term adverse effects	2	10	11	9217	17/10/06 07:43	21	effects	negative
81955375	Medical use and clinical studies	2	13	8	869	17/10/06 07:43	21	uses	positive
81955375	Safety and contraindications	1	14	7	2843	17/10/06 07:43	21	safety	neutral
81980200	Effects	1	4	18	12	17/10/06 12:00	22	effects	neutral
81980200	Short-term neurochemical effects	2	6	16	894	17/10/06 12:00	22	effects	neutral
81980200	Subjective effects	2	7	15	1014	17/10/06 12:00	22	effects	neutral
81980200	Other short-term effects	2	8	14	274	17/10/06 12:00	22	effects	neutral
81980200	Acute toxic/dangerous effects	2	9	13	4581	17/10/06 12:00	22	effects	negative
81980200	Addiction and Tolerance	2	10	12	1392	17/10/06 12:00	22	effects	negative
81980200	Long-term adverse effects	2	11	11	9217	17/10/06 12:00	22	effects	negative
81980200	Medical use and clinical studies	2	14	8	869	17/10/06 12:00	22	uses	positive
81980200	Safety and contraindications	1	15	7	2843	17/10/06 12:00	22	safety	neutral
82016210	Short-term neurochemical effects	2	4	16	894	17/10/06 16:11	20	effects	neutral
82016210	Subjective effects	2	5	15	1014	17/10/06 16:11	20	effects	neutral
82016210	Other short-term effects	2	6	14	274	17/10/06 16:11	20	effects	neutral
82016210	Acute toxic/dangerous effects	2	7	13	4581	17/10/06 16:11	20	effects	negative
82016210	Addiction and Tolerance	2	8	12	1392	17/10/06 16:11	20	effects	negative
82016210	Long-term adverse effects	2	9	11	9217	17/10/06 16:11	20	effects	negative
82016210	Medical use and clinical studies	2	12	8	869	17/10/06 16:11	20	uses	positive
82016210	Safety and contraindications	1	13	7	2843	17/10/06 16:11	20	safety	neutral
82028467	Effects	1	4	18	12	17/10/06 17:22	22	effects	neutral
82028467	Short-term neurochemical effects	2	6	16	894	17/10/06 17:22	22	effects	neutral
82028467	Subjective effects	2	7	15	1014	17/10/06 17:22	22	effects	neutral
82028467	Other short-term effects	2	8	14	274	17/10/06 17:22	22	effects	neutral
82028467	Acute toxic/dangerous effects	2	9	13	4581	17/10/06 17:22	22	effects	negative
82028467	Addiction and Tolerance	2	10	12	1392	17/10/06 17:22	22	effects	negative
82028467	Long-term adverse effects	2	11	11	9217	17/10/06 17:22	22	effects	negative
82028467	Medical use and clinical studies	2	14	8	869	17/10/06 17:22	22	uses	positive
82028467	Safety and contraindications	1	15	7	2843	17/10/06 17:22	22	safety	neutral
82614775	Effects	1	4	19	12	20/10/06 12:52	23	effects	neutral
82614775	Short-term neurochemical effects	2	7	16	894	20/10/06 12:52	23	effects	neutral
82614775	Subjective effects	2	8	15	1014	20/10/06 12:52	23	effects	neutral
82614775	Other short-term effects	2	9	14	311	20/10/06 12:52	23	effects	neutral
82614775	Acute toxic/dangerous effects	2	10	13	4581	20/10/06 12:52	23	effects	negative
82614775	Addiction and Tolerance	2	11	12	1392	20/10/06 12:52	23	effects	negative
82614775	Long-term adverse effects	2	12	11	9217	20/10/06 12:52	23	effects	negative
82614775	Medical use and clinical studies	2	15	8	869	20/10/06 12:52	23	uses	positive
82614775	Safety and contraindications	1	16	7	2844	20/10/06 12:52	23	safety	neutral
82614775	Physical Effects	2	5	18	422	20/10/06 12:52	23	effects	neutral
82619238	Effects	1	4	18	12	20/10/06 13:26	22	effects	neutral
82619238	Short-term neurochemical effects	2	6	16	894	20/10/06 13:26	22	effects	neutral
82619238	Subjective effects	2	7	15	1014	20/10/06 13:26	22	effects	neutral
82619238	Other short-term effects	2	8	14	274	20/10/06 13:26	22	effects	neutral
82619238	Acute toxic/dangerous effects	2	9	13	4581	20/10/06 13:26	22	effects	negative
82619238	Addiction and Tolerance	2	10	12	1392	20/10/06 13:26	22	effects	negative
82619238	Long-term adverse effects	2	11	11	9217	20/10/06 13:26	22	effects	negative
82619238	Medical use and clinical studies	2	14	8	869	20/10/06 13:26	22	uses	positive
82619238	Safety and contraindications	1	15	7	2844	20/10/06 13:26	22	safety	neutral
85356356	Effects	1	4	17	12	02/11/06 23:03	21	effects	neutral
85356356	Short-term neurochemical effects	2	6	15	894	02/11/06 23:03	21	effects	neutral
85356356	Subjective effects	2	7	14	1014	02/11/06 23:03	21	effects	neutral
85356356	Other short-term effects	2	8	13	277	02/11/06 23:03	21	effects	neutral
85356356	Addiction and Tolerance	2	9	12	1392	02/11/06 23:03	21	effects	negative
85356356	Long-term adverse effects	2	10	11	9217	02/11/06 23:03	21	effects	negative
85356356	Medical use and clinical studies	2	13	8	869	02/11/06 23:03	21	uses	positive
85356356	Safety and contraindications	1	14	7	2866	02/11/06 23:03	21	safety	neutral
85356452	Short-term neurochemical effects	2	4	15	894	02/11/06 23:03	19	effects	neutral
85356452	Subjective effects	2	5	14	1014	02/11/06 23:03	19	effects	neutral
85356452	Other short-term effects	2	6	13	277	02/11/06 23:03	19	effects	neutral
85356452	Addiction and Tolerance	2	7	12	1392	02/11/06 23:03	19	effects	negative
85356452	Long-term adverse effects	2	8	11	9217	02/11/06 23:03	19	effects	negative
85356452	Medical use and clinical studies	2	11	8	869	02/11/06 23:03	19	uses	positive
85356452	Safety and contraindications	1	12	7	2866	02/11/06 23:03	19	safety	neutral
85358589	Effects	1	4	18	12	02/11/06 23:14	22	effects	neutral
85358589	Short-term neurochemical effects	2	6	16	894	02/11/06 23:14	22	effects	neutral
85358589	Subjective effects	2	7	15	1014	02/11/06 23:14	22	effects	neutral
85358589	Other short-term effects	2	8	14	274	02/11/06 23:14	22	effects	neutral
85358589	Acute toxic/dangerous effects	2	9	13	4581	02/11/06 23:14	22	effects	negative
85358589	Addiction and Tolerance	2	10	12	1392	02/11/06 23:14	22	effects	negative
85358589	Long-term adverse effects	2	11	11	9217	02/11/06 23:14	22	effects	negative
85358589	Medical use and clinical studies	2	14	8	869	02/11/06 23:14	22	uses	positive
85358589	Safety and contraindications	1	15	7	2866	02/11/06 23:14	22	safety	neutral
92831938	Effects	1	2	5	12	08/12/06 01:36	7	effects	neutral
92831938	Subjective effects	2	4	3	239	08/12/06 01:36	7	effects	neutral
92831938	Acute toxic/dangerous effects	2	5	2	2808	08/12/06 01:36	7	effects	negative
92831938	Addiction and Tolerance	2	7	0		08/12/06 01:36	7	effects	negative
92853183	Effects	1	4	18	12	08/12/06 03:37	22	effects	neutral
92853183	Short-term neurochemical effects	2	6	16	906	08/12/06 03:37	22	effects	neutral
92853183	Subjective effects	2	7	15	1014	08/12/06 03:37	22	effects	neutral
92853183	Other short-term effects	2	8	14	274	08/12/06 03:37	22	effects	neutral
92853183	Acute toxic/dangerous effects	2	9	13	4580	08/12/06 03:37	22	effects	negative
92853183	Addiction and Tolerance	2	10	12	1392	08/12/06 03:37	22	effects	negative
92853183	Long-term adverse effects	2	11	11	9274	08/12/06 03:37	22	effects	negative
92853183	Medical use and clinical studies	2	14	8	869	08/12/06 03:37	22	uses	positive
92853183	Safety and contraindications	1	15	7	2866	08/12/06 03:37	22	safety	neutral
94430671	Short-term neurochemical effects	2	5	16	906	15/12/06 02:53	21	effects	neutral
94430671	Subjective effects	2	6	15	1014	15/12/06 02:53	21	effects	neutral
94430671	Other short-term effects	2	7	14	294	15/12/06 02:53	21	effects	neutral
94430671	Acute toxic/dangerous effects	2	8	13	4580	15/12/06 02:53	21	effects	negative
94430671	Addiction and Tolerance	2	9	12	1392	15/12/06 02:53	21	effects	negative
94430671	Long-term adverse effects	2	10	11	9274	15/12/06 02:53	21	effects	negative
94430671	Medical use and clinical studies	2	13	8	869	15/12/06 02:53	21	uses	positive
94430671	Safety and contraindications	1	14	7	2866	15/12/06 02:53	21	safety	neutral
94440064	Effects	1	4	18	12	15/12/06 03:51	22	effects	neutral
94440064	Short-term neurochemical effects	2	6	16	906	15/12/06 03:51	22	effects	neutral
94440064	Subjective effects	2	7	15	1014	15/12/06 03:51	22	effects	neutral
94440064	Other short-term effects	2	8	14	294	15/12/06 03:51	22	effects	neutral
94440064	Acute toxic/dangerous effects	2	9	13	4580	15/12/06 03:51	22	effects	negative
94440064	Addiction and Tolerance	2	10	12	1392	15/12/06 03:51	22	effects	negative
94440064	Long-term adverse effects	2	11	11	9274	15/12/06 03:51	22	effects	negative
94440064	Medical use and clinical studies	2	14	8	869	15/12/06 03:51	22	uses	positive
94440064	Safety and contraindications	1	15	7	2866	15/12/06 03:51	22	safety	neutral
95101440	Short-term neurochemical effects	2	5	16	906	18/12/06 15:11	21	effects	neutral
95101440	Subjective effects	2	6	15	1018	18/12/06 15:11	21	effects	neutral
95101440	Other short-term effects	2	7	14	407	18/12/06 15:11	21	effects	neutral
95101440	Acute toxic/dangerous effects	2	8	13	4580	18/12/06 15:11	21	effects	negative
95101440	Addiction and Tolerance	2	9	12	1392	18/12/06 15:11	21	effects	negative
95101440	Long-term adverse effects	2	10	11	9282	18/12/06 15:11	21	effects	negative
95101440	Medical use and clinical studies	2	13	8	869	18/12/06 15:11	21	uses	positive
95101440	Safety and contraindications	1	14	7	2867	18/12/06 15:11	21	safety	neutral
95101482	Effects	1	4	18	14	18/12/06 15:12	22	effects	neutral
95101482	Short-term neurochemical effects	2	6	16	906	18/12/06 15:12	22	effects	neutral
95101482	Subjective effects	2	7	15	1018	18/12/06 15:12	22	effects	neutral
95101482	Other short-term effects	2	8	14	407	18/12/06 15:12	22	effects	neutral
95101482	Acute toxic/dangerous effects	2	9	13	4580	18/12/06 15:12	22	effects	negative
95101482	Addiction and Tolerance	2	10	12	1392	18/12/06 15:12	22	effects	negative
95101482	Long-term adverse effects	2	11	11	9282	18/12/06 15:12	22	effects	negative
95101482	Medical use and clinical studies	2	14	8	869	18/12/06 15:12	22	uses	positive
95101482	Safety and contraindications	1	15	7	2867	18/12/06 15:12	22	safety	neutral
102497793	Effects	1	4	20	77	22/01/07 20:02	24	effects	neutral
102497793	Subjective effects	2	6	18	1017	22/01/07 20:02	24	effects	neutral
102497793	Other short-term effects	2	7	17	714	22/01/07 20:02	24	effects	neutral
102497793	Acute toxic/dangerous effects	2	8	16	5593	22/01/07 20:02	24	effects	negative
102497793	Addiction and Tolerance	2	9	15	2111	22/01/07 20:02	24	effects	negative
102497793	Long-term adverse effects	2	10	14	9297	22/01/07 20:02	24	effects	negative
102497793	Medical use and clinical studies	2	14	10	869	22/01/07 20:02	24	uses	positive
102497793	Safety and contraindications	1	15	9	2872	22/01/07 20:02	24	safety	neutral
102498483	Effects	1	4	21	77	22/01/07 20:05	25	effects	neutral
102498483	Short-term neurochemical effects	2	6	19	920	22/01/07 20:05	25	effects	neutral
102498483	Subjective effects	2	7	18	1017	22/01/07 20:05	25	effects	neutral
102498483	Other short-term effects	2	8	17	714	22/01/07 20:05	25	effects	neutral
102498483	Acute toxic/dangerous effects	2	9	16	5593	22/01/07 20:05	25	effects	negative
102498483	Addiction and Tolerance	2	10	15	2111	22/01/07 20:05	25	effects	negative
102498483	Long-term adverse effects	2	11	14	9297	22/01/07 20:05	25	effects	negative
102498483	Medical use and clinical studies	2	15	10	869	22/01/07 20:05	25	uses	positive
102498483	Safety and contraindications	1	16	9	2872	22/01/07 20:05	25	safety	neutral
102768142	Short-term neurochemical effects	2	5	19	920	23/01/07 22:30	24	effects	neutral
102768142	Subjective effects	2	6	18	1017	23/01/07 22:30	24	effects	neutral
102768142	Other short-term effects	2	7	17	714	23/01/07 22:30	24	effects	neutral
102768142	Acute toxic/dangerous effects	2	8	16	5803	23/01/07 22:30	24	effects	negative
102768142	Addiction and Tolerance	2	9	15	2111	23/01/07 22:30	24	effects	negative
102768142	Long-term adverse effects	2	10	14	9506	23/01/07 22:30	24	effects	negative
102768142	Medical use and clinical studies	2	14	10	869	23/01/07 22:30	24	uses	positive
102768142	Safety and contraindications	1	15	9	2872	23/01/07 22:30	24	safety	neutral
102768401	Effects	1	4	21	77	23/01/07 22:31	25	effects	neutral
102768401	Short-term neurochemical effects	2	6	19	920	23/01/07 22:31	25	effects	neutral
102768401	Subjective effects	2	7	18	1017	23/01/07 22:31	25	effects	neutral
102768401	Other short-term effects	2	8	17	714	23/01/07 22:31	25	effects	neutral
102768401	Acute toxic/dangerous effects	2	9	16	5803	23/01/07 22:31	25	effects	negative
102768401	Addiction and Tolerance	2	10	15	2111	23/01/07 22:31	25	effects	negative
102768401	Long-term adverse effects	2	11	14	9506	23/01/07 22:31	25	effects	negative
102768401	Medical use and clinical studies	2	15	10	869	23/01/07 22:31	25	uses	positive
102768401	Safety and contraindications	1	16	9	2872	23/01/07 22:31	25	safety	neutral
103145173	Medical use and clinical studies	2	6	10	869	25/01/07 14:40	16	uses	positive
103145173	Safety and contraindications	1	7	9	2872	25/01/07 14:40	16	safety	neutral
103145271	Effects	1	4	21	77	25/01/07 14:40	25	effects	neutral
103145271	Short-term neurochemical effects	2	6	19	920	25/01/07 14:40	25	effects	neutral
103145271	Subjective effects	2	7	18	1017	25/01/07 14:40	25	effects	neutral
103145271	Other short-term effects	2	8	17	714	25/01/07 14:40	25	effects	neutral
103145271	Acute toxic/dangerous effects	2	9	16	5803	25/01/07 14:40	25	effects	negative
103145271	Addiction and Tolerance	2	10	15	2111	25/01/07 14:40	25	effects	negative
103145271	Long-term adverse effects	2	11	14	9506	25/01/07 14:40	25	effects	negative
103145271	Medical use and clinical studies	2	15	10	869	25/01/07 14:40	25	uses	positive
103145271	Safety and contraindications	1	16	9	2872	25/01/07 14:40	25	safety	neutral
103214421	Medical use and clinical studies	2	6	10	869	25/01/07 20:19	16	uses	positive
103214421	Safety and contraindications	1	7	9	2872	25/01/07 20:19	16	safety	neutral
103218553	Effects	1	4	21	77	25/01/07 20:37	25	effects	neutral
103218553	Short-term neurochemical effects	2	6	19	920	25/01/07 20:37	25	effects	neutral
103218553	Subjective effects	2	7	18	1017	25/01/07 20:37	25	effects	neutral
103218553	Other short-term effects	2	8	17	714	25/01/07 20:37	25	effects	neutral
103218553	Acute toxic/dangerous effects	2	9	16	5803	25/01/07 20:37	25	effects	negative
103218553	Addiction and Tolerance	2	10	15	2111	25/01/07 20:37	25	effects	negative
103218553	Long-term adverse effects	2	11	14	9506	25/01/07 20:37	25	effects	negative
103218553	Medical use and clinical studies	2	15	10	869	25/01/07 20:37	25	uses	positive
103218553	Safety and contraindications	1	16	9	2872	25/01/07 20:37	25	safety	neutral
103788548	Effects	1	4	13	20	28/01/07 07:13	17	effects	neutral
103788548	Medical use and clinical studies	2	7	10	869	28/01/07 07:13	17	uses	positive
103788548	Safety and contraindications	1	8	9	2872	28/01/07 07:13	17	safety	neutral
103788653	Effects	1	4	21	77	28/01/07 07:14	25	effects	neutral
103788653	Short-term neurochemical effects	2	6	19	920	28/01/07 07:14	25	effects	neutral
103788653	Subjective effects	2	7	18	1017	28/01/07 07:14	25	effects	neutral
103788653	Other short-term effects	2	8	17	714	28/01/07 07:14	25	effects	neutral
103788653	Acute toxic/dangerous effects	2	9	16	5803	28/01/07 07:14	25	effects	negative
103788653	Addiction and Tolerance	2	10	15	2111	28/01/07 07:14	25	effects	negative
103788653	Long-term adverse effects	2	11	14	9506	28/01/07 07:14	25	effects	negative
103788653	Medical use and clinical studies	2	15	10	869	28/01/07 07:14	25	uses	positive
103788653	Safety and contraindications	1	16	9	2872	28/01/07 07:14	25	safety	neutral
104426914	Effects	1	4	20	77	30/01/07 22:05	24	effects	neutral
104426914	Short-term neurochemical effects	2	6	18	920	30/01/07 22:05	24	effects	neutral
104426914	Subjective effects	2	7	17	1073	30/01/07 22:05	24	effects	neutral
104426914	Acute toxic/dangerous effects	2	8	16	5803	30/01/07 22:05	24	effects	negative
104426914	Addiction and Tolerance	2	9	15	2111	30/01/07 22:05	24	effects	negative
104426914	Long-term adverse effects	2	10	14	9506	30/01/07 22:05	24	effects	negative
104426914	Medical use and clinical studies	2	14	10	869	30/01/07 22:05	24	uses	positive
104426914	Safety and contraindications	1	15	9	2869	30/01/07 22:05	24	safety	neutral
104429209	Effects	1	4	21	77	30/01/07 22:15	25	effects	neutral
104429209	Short-term neurochemical effects	2	6	19	920	30/01/07 22:15	25	effects	neutral
104429209	Subjective effects	2	7	18	1017	30/01/07 22:15	25	effects	neutral
104429209	Other short-term effects	2	8	17	714	30/01/07 22:15	25	effects	neutral
104429209	Acute toxic/dangerous effects	2	9	16	5803	30/01/07 22:15	25	effects	negative
104429209	Addiction and Tolerance	2	10	15	2111	30/01/07 22:15	25	effects	negative
104429209	Long-term adverse effects	2	11	14	9506	30/01/07 22:15	25	effects	negative
104429209	Medical use and clinical studies	2	15	10	869	30/01/07 22:15	25	uses	positive
104429209	Safety and contraindications	1	16	9	2869	30/01/07 22:15	25	safety	neutral
108613879	Short-term neurochemical effects	2	6	19	916	16/02/07 15:14	25	effects	neutral
108613879	Subjective effects	2	7	18	1022	16/02/07 15:14	25	effects	neutral
108613879	Other short-term effects	2	8	17	715	16/02/07 15:14	25	effects	neutral
108613879	Acute toxic/dangerous effects	2	9	16	5807	16/02/07 15:14	25	effects	negative
108613879	Addiction and Tolerance	2	10	15	2115	16/02/07 15:14	25	effects	negative
108613879	Long-term adverse effects	2	11	14	9578	16/02/07 15:14	25	effects	negative
108613879	Medical use and clinical studies	2	15	10	869	16/02/07 15:14	25	uses	positive
108613879	Safety and contraindications	1	16	9	2921	16/02/07 15:14	25	safety	neutral
108643050	Effects	1	4	21	76	16/02/07 17:31	25	effects	neutral
108643050	Short-term neurochemical effects	2	6	19	916	16/02/07 17:31	25	effects	neutral
108643050	Subjective effects	2	7	18	1022	16/02/07 17:31	25	effects	neutral
108643050	Other short-term effects	2	8	17	715	16/02/07 17:31	25	effects	neutral
108643050	Acute toxic/dangerous effects	2	9	16	5807	16/02/07 17:31	25	effects	negative
108643050	Addiction and Tolerance	2	10	15	2115	16/02/07 17:31	25	effects	negative
108643050	Long-term adverse effects	2	11	14	9578	16/02/07 17:31	25	effects	negative
108643050	Medical use and clinical studies	2	15	10	869	16/02/07 17:31	25	uses	positive
108643050	Safety and contraindications	1	16	9	2921	16/02/07 17:31	25	safety	neutral
112761932	Effects	1	4	19	76	05/03/07 07:30	23	effects	neutral
112761932	Short-term neurochemical effects	2	6	17	917	05/03/07 07:30	23	effects	neutral
112761932	Subjective effects	2	7	16	8303	05/03/07 07:30	23	effects	neutral
112761932	Addiction and Tolerance	2	8	15	2466	05/03/07 07:30	23	effects	negative
112761932	Long-term adverse effects	2	9	14	9641	05/03/07 07:30	23	effects	negative
112761932	Medical use and clinical studies	2	13	10	869	05/03/07 07:30	23	uses	positive
112761932	Safety and contraindications	1	14	9	2921	05/03/07 07:30	23	safety	neutral
112762073	Effects	1	4	21	76	05/03/07 07:31	25	effects	neutral
112762073	Short-term neurochemical effects	2	6	19	917	05/03/07 07:31	25	effects	neutral
112762073	Subjective effects	2	7	18	1547	05/03/07 07:31	25	effects	neutral
112762073	Other short-term effects	2	8	17	715	05/03/07 07:31	25	effects	neutral
112762073	Acute toxic/dangerous effects	2	9	16	6044	05/03/07 07:31	25	effects	negative
112762073	Addiction and Tolerance	2	10	15	2466	05/03/07 07:31	25	effects	negative
112762073	Long-term adverse effects	2	11	14	9641	05/03/07 07:31	25	effects	negative
112762073	Medical use and clinical studies	2	15	10	869	05/03/07 07:31	25	uses	positive
112762073	Safety and contraindications	1	16	9	2921	05/03/07 07:31	25	safety	neutral
114196960	Effects	1	4	20	1361	11/03/07 01:38	24	effects	neutral
114196960	Short-term neurochemical effects	2	6	18	917	11/03/07 01:38	24	effects	neutral
114196960	Subjective effects	2	7	17	1553	11/03/07 01:38	24	effects	neutral
114196960	Other short-term effects	2	8	16	755	11/03/07 01:38	24	effects	neutral
114196960	Acute toxic/dangerous effects	2	9	15	8816	11/03/07 01:38	24	effects	negative
114196960	Long-term adverse effects	2	10	14	9730	11/03/07 01:38	24	effects	negative
114196960	Medical use and clinical studies	2	14	10	869	11/03/07 01:38	24	uses	positive
114196960	Safety and contraindications	1	15	9	2921	11/03/07 01:38	24	safety	neutral
114212482	Effects	1	4	21	1361	11/03/07 02:55	25	effects	neutral
114212482	Short-term neurochemical effects	2	6	19	917	11/03/07 02:55	25	effects	neutral
114212482	Subjective effects	2	7	18	1553	11/03/07 02:55	25	effects	neutral
114212482	Other short-term effects	2	8	17	755	11/03/07 02:55	25	effects	neutral
114212482	Acute toxic/dangerous effects	2	9	16	6044	11/03/07 02:55	25	effects	negative
114212482	Addiction and Tolerance	2	10	15	2748	11/03/07 02:55	25	effects	negative
114212482	Long-term adverse effects	2	11	14	9730	11/03/07 02:55	25	effects	negative
114212482	Medical use and clinical studies	2	15	10	869	11/03/07 02:55	25	uses	positive
114212482	Safety and contraindications	1	16	9	2921	11/03/07 02:55	25	safety	neutral
115082659	Medical use and clinical studies	2	5	10	869	14/03/07 16:05	15	uses	positive
115082659	Safety and contraindications	1	6	9	2921	14/03/07 16:05	15	safety	neutral
115085317	Effects	1	4	21	1361	14/03/07 16:16	25	effects	neutral
115085317	Short-term neurochemical effects	2	6	19	917	14/03/07 16:16	25	effects	neutral
115085317	Subjective effects	2	7	18	1553	14/03/07 16:16	25	effects	neutral
115085317	Other short-term effects	2	8	17	998	14/03/07 16:16	25	effects	neutral
115085317	Acute toxic/dangerous effects	2	9	16	6044	14/03/07 16:16	25	effects	negative
115085317	Addiction and Tolerance	2	10	15	2748	14/03/07 16:16	25	effects	negative
115085317	Long-term adverse effects	2	11	14	9730	14/03/07 16:16	25	effects	negative
115085317	Medical use and clinical studies	2	15	10	869	14/03/07 16:16	25	uses	positive
115085317	Safety and contraindications	1	16	9	2921	14/03/07 16:16	25	safety	neutral
115549427	Effects	1	4	13	312	16/03/07 13:29	17	effects	neutral
115549427	Medical use and clinical studies	2	7	10	869	16/03/07 13:29	17	uses	positive
115549427	Safety and contraindications	1	8	9	2921	16/03/07 13:29	17	safety	neutral
115550133	Effects	1	4	21	1361	16/03/07 13:33	25	effects	neutral
115550133	Short-term neurochemical effects	2	6	19	917	16/03/07 13:33	25	effects	neutral
115550133	Subjective effects	2	7	18	1553	16/03/07 13:33	25	effects	neutral
115550133	Other short-term effects	2	8	17	998	16/03/07 13:33	25	effects	neutral
115550133	Acute toxic/dangerous effects	2	9	16	6045	16/03/07 13:33	25	effects	negative
115550133	Addiction and Tolerance	2	10	15	2748	16/03/07 13:33	25	effects	negative
115550133	Long-term adverse effects	2	11	14	9730	16/03/07 13:33	25	effects	negative
115550133	Medical use and clinical studies	2	15	10	869	16/03/07 13:33	25	uses	positive
115550133	Safety and contraindications	1	16	9	2921	16/03/07 13:33	25	safety	neutral
118057241	Effects	1	4	14	13	26/03/07 18:32	18	effects	neutral
118057241	Subjective effects	2	6	12	3322	26/03/07 18:32	18	effects	neutral
118057241	Medical use and clinical studies	2	8	10	869	26/03/07 18:32	18	uses	positive
118057241	Safety and contraindications	1	9	9	2921	26/03/07 18:32	18	safety	neutral
118057423	Effects	1	4	21	13	26/03/07 18:33	25	effects	neutral
118057423	Short-term neurochemical effects	2	6	19	917	26/03/07 18:33	25	effects	neutral
118057423	Subjective effects	2	7	18	1549	26/03/07 18:33	25	effects	neutral
118057423	Other short-term effects	2	8	17	755	26/03/07 18:33	25	effects	neutral
118057423	Acute toxic/dangerous effects	2	9	16	5636	26/03/07 18:33	25	effects	negative
118057423	Addiction and Tolerance	2	10	15	2748	26/03/07 18:33	25	effects	negative
118057423	Long-term adverse effects	2	11	14	9778	26/03/07 18:33	25	effects	negative
118057423	Medical use and clinical studies	2	15	10	869	26/03/07 18:33	25	uses	positive
118057423	Safety and contraindications	1	16	9	2921	26/03/07 18:33	25	safety	neutral
118057426	Effects	1	4	20	13	26/03/07 18:33	24	effects	neutral
118057426	Short-term neurochemical effects	2	6	18	917	26/03/07 18:33	24	effects	neutral
118057426	Subjective effects	2	7	17	1549	26/03/07 18:33	24	effects	neutral
118057426	Other short-term effects	2	8	16	755	26/03/07 18:33	24	effects	neutral
118057426	Acute toxic/dangerous effects	2	9	15	5636	26/03/07 18:33	24	effects	negative
118057426	Addiction and Tolerance	2	10	14	2748	26/03/07 18:33	24	effects	negative
118057426	Long-term adverse effects	2	11	13	9778	26/03/07 18:33	24	effects	negative
118057426	Safety and contraindications	1	15	9	2921	26/03/07 18:33	24	safety	neutral
118057459	Effects	1	4	21	13	26/03/07 18:33	25	effects	neutral
118057459	Short-term neurochemical effects	2	6	19	917	26/03/07 18:33	25	effects	neutral
118057459	Subjective effects	2	7	18	1549	26/03/07 18:33	25	effects	neutral
118057459	Other short-term effects	2	8	17	755	26/03/07 18:33	25	effects	neutral
118057459	Acute toxic/dangerous effects	2	9	16	5636	26/03/07 18:33	25	effects	negative
118057459	Addiction and Tolerance	2	10	15	2748	26/03/07 18:33	25	effects	negative
118057459	Long-term adverse effects	2	11	14	9778	26/03/07 18:33	25	effects	negative
118057459	Medical use and clinical studies	2	15	10	869	26/03/07 18:33	25	uses	positive
118057459	Safety and contraindications	1	16	9	2921	26/03/07 18:33	25	safety	neutral
125606767	Medical use and clinical studies	2	8	10	865	24/04/07 19:55	18	uses	positive
125606767	Safety and contraindications	1	9	9	2610	24/04/07 19:55	18	safety	neutral
125606832	Effects	1	6	21	13	24/04/07 19:55	27	effects	neutral
125606832	Short-term neurochemical effects	2	8	19	1536	24/04/07 19:55	27	effects	neutral
125606832	Subjective effects	2	9	18	1549	24/04/07 19:55	27	effects	neutral
125606832	Other short-term effects	2	10	17	766	24/04/07 19:55	27	effects	neutral
125606832	Acute toxic/dangerous effects	2	11	16	6125	24/04/07 19:55	27	effects	negative
125606832	Addiction and Tolerance	2	12	15	2748	24/04/07 19:55	27	effects	negative
125606832	Long-term adverse effects	2	13	14	10134	24/04/07 19:55	27	effects	negative
125606832	Medical use and clinical studies	2	17	10	865	24/04/07 19:55	27	uses	positive
125606832	Safety and contraindications	1	18	9	2610	24/04/07 19:55	27	safety	neutral
128343993	Effects	1	6	21	13	05/05/07 02:06	27	effects	neutral
128343993	Short-term neurochemical effects	2	8	19	1536	05/05/07 02:06	27	effects	neutral
128343993	Subjective effects	2	9	18	1549	05/05/07 02:06	27	effects	neutral
128343993	Other short-term effects	2	10	17	766	05/05/07 02:06	27	effects	neutral
128343993	Acute toxic/dangerous effects	2	11	16	17566	05/05/07 02:06	27	effects	negative
128343993	Addiction and Tolerance	2	12	15	3453	05/05/07 02:06	27	effects	negative
128343993	Long-term adverse effects	2	13	14	12548	05/05/07 02:06	27	effects	negative
128343993	Medical use and clinical studies	2	17	10	865	05/05/07 02:06	27	uses	positive
128343993	Safety and contraindications	1	18	9	2681	05/05/07 02:06	27	safety	neutral
128343993	Use in psychotherapy	1	14	13	1222	05/05/07 02:06	27	uses	positive
129349262	Effects	1	7	23	14	08/05/07 21:09	30	effects	neutral
129349262	Short-term neurochemical effects	2	9	21	1536	08/05/07 21:09	30	effects	neutral
129349262	Subjective effects	2	10	20	1549	08/05/07 21:09	30	effects	neutral
129349262	Other short-term effects	2	11	19	774	08/05/07 21:09	30	effects	neutral
129349262	Acute toxic/dangerous effects	2	12	18	1418	08/05/07 21:09	30	effects	negative
129349262	Addiction and Tolerance	2	15	15	3453	08/05/07 21:09	30	effects	negative
129349262	Long-term adverse effects	2	16	14	12548	08/05/07 21:09	30	effects	negative
129349262	Medical use and clinical studies	2	20	10	865	08/05/07 21:09	30	uses	positive
129349262	Safety and contraindications	1	21	9	2681	08/05/07 21:09	30	safety	neutral
129349262	Use in psychotherapy	1	17	13	1222	08/05/07 21:09	30	uses	positive
129349262	Hyponatremia	2	13	17	1913	08/05/07 21:09	30	effects	negative
129349308	Effects	1	7	21	14	08/05/07 21:09	28	effects	neutral
129349308	Short-term neurochemical effects	2	9	19	1536	08/05/07 21:09	28	effects	neutral
129349308	Subjective effects	2	10	18	1549	08/05/07 21:09	28	effects	neutral
129349308	Other short-term effects	2	11	17	766	08/05/07 21:09	28	effects	neutral
129349308	Acute toxic/dangerous effects	2	12	16	17661	08/05/07 21:09	28	effects	negative
129349308	Addiction and Tolerance	2	13	15	3453	08/05/07 21:09	28	effects	negative
129349308	Long-term adverse effects	2	14	14	12548	08/05/07 21:09	28	effects	negative
129349308	Medical use and clinical studies	2	18	10	865	08/05/07 21:09	28	uses	positive
129349308	Safety and contraindications	1	19	9	2681	08/05/07 21:09	28	safety	neutral
129349308	Use in psychotherapy	1	15	13	1222	08/05/07 21:09	28	uses	positive
129349410	Effects	1	7	23	14	08/05/07 21:10	30	effects	neutral
129349410	Short-term neurochemical effects	2	9	21	1536	08/05/07 21:10	30	effects	neutral
129349410	Subjective effects	2	10	20	1549	08/05/07 21:10	30	effects	neutral
129349410	Other short-term effects	2	11	19	774	08/05/07 21:10	30	effects	neutral
129349410	Acute toxic/dangerous effects	2	12	18	1418	08/05/07 21:10	30	effects	negative
129349410	Addiction and Tolerance	2	15	15	3453	08/05/07 21:10	30	effects	negative
129349410	Long-term adverse effects	2	16	14	12548	08/05/07 21:10	30	effects	negative
129349410	Medical use and clinical studies	2	20	10	865	08/05/07 21:10	30	uses	positive
129349410	Safety and contraindications	1	21	9	2681	08/05/07 21:10	30	safety	neutral
129349410	Use in psychotherapy	1	17	13	1222	08/05/07 21:10	30	uses	positive
129349410	Hyponatremia	2	13	17	1913	08/05/07 21:10	30	effects	negative
129349647	Effects	1	7	21	14	08/05/07 21:11	28	effects	neutral
129349647	Short-term neurochemical effects	2	9	19	1536	08/05/07 21:11	28	effects	neutral
129349647	Subjective effects	2	10	18	1549	08/05/07 21:11	28	effects	neutral
129349647	Other short-term effects	2	11	17	766	08/05/07 21:11	28	effects	neutral
129349647	Acute toxic/dangerous effects	2	12	16	17661	08/05/07 21:11	28	effects	negative
129349647	Addiction and Tolerance	2	13	15	3453	08/05/07 21:11	28	effects	negative
129349647	Long-term adverse effects	2	14	14	12548	08/05/07 21:11	28	effects	negative
129349647	Medical use and clinical studies	2	18	10	865	08/05/07 21:11	28	uses	positive
129349647	Safety and contraindications	1	19	9	2681	08/05/07 21:11	28	safety	neutral
129349647	Use in psychotherapy	1	15	13	1222	08/05/07 21:11	28	uses	positive
129349807	Effects	1	7	23	14	08/05/07 21:11	30	effects	neutral
129349807	Short-term neurochemical effects	2	9	21	1536	08/05/07 21:11	30	effects	neutral
129349807	Subjective effects	2	10	20	1549	08/05/07 21:11	30	effects	neutral
129349807	Other short-term effects	2	11	19	774	08/05/07 21:11	30	effects	neutral
129349807	Acute toxic/dangerous effects	2	12	18	1418	08/05/07 21:11	30	effects	negative
129349807	Addiction and Tolerance	2	15	15	3453	08/05/07 21:11	30	effects	negative
129349807	Long-term adverse effects	2	16	14	12548	08/05/07 21:11	30	effects	negative
129349807	Medical use and clinical studies	2	20	10	865	08/05/07 21:11	30	uses	positive
129349807	Safety and contraindications	1	21	9	2681	08/05/07 21:11	30	safety	neutral
129349807	Use in psychotherapy	1	17	13	1222	08/05/07 21:11	30	uses	positive
129349807	Hyponatremia	2	13	17	1913	08/05/07 21:11	30	effects	negative
129355903	Effects	1	7	14	59	08/05/07 21:37	21	effects	neutral
129355903	Medical use and clinical studies	2	11	10	865	08/05/07 21:37	21	uses	positive
129355903	Safety and contraindications	1	12	9	2681	08/05/07 21:37	21	safety	neutral
129355903	Use in psychotherapy	1	8	13	1222	08/05/07 21:37	21	uses	positive
129815066	Effects	1	6	13	59	10/05/07 13:38	19	effects	neutral
129815066	Safety and contraindications	1	10	9	2704	10/05/07 13:38	19	safety	neutral
129815066	Use in psychotherapy	1	7	12	1222	10/05/07 13:38	19	uses	positive
129822739	Effects	1	7	14	59	10/05/07 14:07	21	effects	neutral
129822739	Medical use and clinical studies	2	11	10	865	10/05/07 14:07	21	uses	positive
129822739	Safety and contraindications	1	12	9	2704	10/05/07 14:07	21	safety	neutral
129822739	Use in psychotherapy	1	8	13	1222	10/05/07 14:07	21	uses	positive
130501631	Effects	1	7	13	59	13/05/07 08:45	20	effects	neutral
130501631	Medical use and clinical studies	2	11	9	881	13/05/07 08:45	20	uses	positive
130501631	Use in psychotherapy	1	8	12	1222	13/05/07 08:45	20	uses	positive
130501651	Effects	1	7	13	59	13/05/07 08:45	20	effects	neutral
130501651	Medical use and clinical studies	2	11	9	881	13/05/07 08:45	20	uses	positive
130501651	Safety and contraindications	1	12	8	2622	13/05/07 08:45	20	safety	neutral
130501651	Use in psychotherapy	1	8	12	1222	13/05/07 08:45	20	uses	positive
131207386	Effects	1	7	14	59	16/05/07 03:01	21	effects	neutral
131207386	Medical use and clinical studies	2	11	10	865	16/05/07 03:01	21	uses	positive
131207386	Use in psychotherapy	1	8	13	1222	16/05/07 03:01	21	uses	positive
131207386	Safety and contradications	1	12	9	2652	16/05/07 03:01	21	safety	neutral
132898695	Effects	1	7	8	123	23/05/07 10:11	15	effects	neutral
132898695	Medical use and clinical studies	2	10	5	865	23/05/07 10:11	15	uses	positive
132898695	Safety and contradications	1	11	4	2631	23/05/07 10:11	15	safety	neutral
132899370	Effects	1	7	9	59	23/05/07 10:17	16	effects	neutral
132899370	Medical use and clinical studies	2	11	5	865	23/05/07 10:17	16	uses	positive
132899370	Use in psychotherapy	1	8	8	1222	23/05/07 10:17	16	uses	positive
132899370	Safety and contradications	1	12	4	2631	23/05/07 10:17	16	safety	neutral
136111904	Effects	1	7	9	59	05/06/07 18:24	16	effects	neutral
136111904	Medical use and clinical studies	2	11	5	865	05/06/07 18:24	16	uses	positive
136111904	Use in psychotherapy	1	8	8	1222	05/06/07 18:24	16	uses	positive
136111904	Safety and contradindications	1	12	4	2702	05/06/07 18:24	16	safety	neutral
136141059	Effects	1	7	9	59	05/06/07 20:31	16	effects	neutral
136141059	Medical use and clinical studies	2	11	5	865	05/06/07 20:31	16	uses	positive
136141059	Safety and contraindications	1	12	4	2701	05/06/07 20:31	16	safety	neutral
136141059	Use in psychotherapy	1	8	8	1222	05/06/07 20:31	16	uses	positive
137274740	Effects	1	7	9	59	10/06/07 17:22	16	effects	neutral
137274740	Medical use and clinical studies	2	11	5	865	10/06/07 17:22	16	uses	positive
137274740	Use in psychotherapy	1	8	8	1222	10/06/07 17:22	16	uses	positive
137274740	Safety and contradications	1	12	4	2921	10/06/07 17:22	16	safety	neutral
137938702	Effects	1	7	9	59	13/06/07 17:20	16	effects	neutral
137938702	Medical use and clinical studies	2	11	5	865	13/06/07 17:20	16	uses	positive
137938702	Use in psychotherapy	1	8	8	1222	13/06/07 17:20	16	uses	positive
137938702	Safety and Contraindications	1	12	4	2925	13/06/07 17:20	16	safety	neutral
137938797	Effects	1	7	9	59	13/06/07 17:20	16	effects	neutral
137938797	Medical use and clinical studies	2	11	5	865	13/06/07 17:20	16	uses	positive
137938797	Safety and contraindications	1	12	4	2925	13/06/07 17:20	16	safety	neutral
137938797	Use in psychotherapy	1	8	8	1222	13/06/07 17:20	16	uses	positive
139989996	Effects	1	9	10	59	22/06/07 21:34	19	effects	neutral
139989996	Medical use and clinical studies	2	14	5	865	22/06/07 21:34	19	uses	positive
139989996	Safety and contraindications	1	15	4	2925	22/06/07 21:34	19	safety	neutral
139989996	Use in psychotherapy	1	10	9	1222	22/06/07 21:34	19	uses	positive
139989996	Health Risks	1	13	6	1710	22/06/07 21:34	19	safety	negative
139991021	Effects	1	1	17	747	22/06/07 21:39	18	effects	neutral
139991021	Medical use and clinical studies	2	14	4	866	22/06/07 21:39	18	uses	positive
139991021	Safety	2	13	5	2904	22/06/07 21:39	18	safety	neutral
139991021	Use in psychotherapy	1	9	9	1222	22/06/07 21:39	18	uses	positive
139991021	Health Risks	1	12	6	1710	22/06/07 21:39	18	safety	negative
139992404	Effects	1	1	16	747	22/06/07 21:47	17	effects	neutral
139992404	Safety	2	13	4	2904	22/06/07 21:47	17	safety	neutral
139992404	Use in psychotherapy	1	9	8	1854	22/06/07 21:47	17	uses	positive
139992404	Health Risks	1	12	5	1710	22/06/07 21:47	17	safety	negative
139993463	Safety	2	13	4	2904	22/06/07 21:53	17	safety	neutral
139993463	Use in psychotherapy	1	9	8	1854	22/06/07 21:53	17	uses	positive
139993463	Health Risks	1	12	5	1710	22/06/07 21:53	17	safety	negative
140021000	Effects	1	1	16	747	23/06/07 00:45	17	effects	neutral
140021000	Safety	2	13	4	2904	23/06/07 00:45	17	safety	neutral
140021000	Use in psychotherapy	1	9	8	1854	23/06/07 00:45	17	uses	positive
140021000	Health Risks	1	12	5	1710	23/06/07 00:45	17	safety	negative
143655149	Effects	1	1	17	747	10/07/07 04:12	18	effects	neutral
143655149	Safety	2	13	5	2877	10/07/07 04:12	18	safety	neutral
143655149	Use in psychotherapy	1	9	9	1854	10/07/07 04:12	18	uses	positive
143655149	Health risks	1	12	6	1702	10/07/07 04:12	18	safety	negative
144151095	Effects	1	1	17	704	12/07/07 09:43	18	effects	neutral
144151095	Safety	2	13	5	2877	12/07/07 09:43	18	safety	neutral
144151095	Use in psychotherapy	1	9	9	1854	12/07/07 09:43	18	uses	positive
144151095	Health Risks	1	12	6	1702	12/07/07 09:43	18	safety	negative
144778564	Effects	1	1	16	842	15/07/07 11:51	17	effects	neutral
144778564	Use in psychotherapy	1	9	8	1854	15/07/07 11:51	17	uses	positive
144778564	Health Risks	1	12	5	7660	15/07/07 11:51	17	safety	negative
145038388	Use in psychotherapy	1	8	8	1854	16/07/07 17:36	16	uses	positive
145038388	Health Risks	1	11	5	7638	16/07/07 17:36	16	safety	negative
145038491	Effects	1	1	16	972	16/07/07 17:37	17	effects	neutral
145038491	Use in psychotherapy	1	9	8	1854	16/07/07 17:37	17	uses	positive
145038491	Health Risks	1	12	5	7638	16/07/07 17:37	17	safety	negative
145133525	Effects	1	2	17	160	17/07/07 01:53	19	effects	neutral
145133525	Subjective effects	2	4	15	549	17/07/07 01:53	19	effects	neutral
145133525	Use in psychotherapy	1	11	8	1854	17/07/07 01:53	19	uses	positive
145133525	Health Risks	1	14	5	7638	17/07/07 01:53	19	safety	negative
145133525	Physical effects	2	3	16	317	17/07/07 01:53	19	effects	neutral
147747457	Effects	1	2	16	162	28/07/07 23:31	18	effects	neutral
147747457	Subjective effects	2	3	15	582	28/07/07 23:31	18	effects	neutral
147747457	Use in psychotherapy	1	10	8	1854	28/07/07 23:31	18	uses	positive
147747457	Health Risks	1	13	5	7692	28/07/07 23:31	18	safety	negative
155351427	Effects	1	2	14	202	03/09/07 05:06	16	effects	neutral
155351427	Use in psychotherapy	1	8	8	2546	03/09/07 05:06	16	uses	positive
155351427	Health Risks	1	11	5	7727	03/09/07 05:06	16	safety	negative
155351668	Effects	1	2	16	160	03/09/07 05:07	18	effects	neutral
155351668	Subjective effects	2	3	15	1205	03/09/07 05:07	18	effects	neutral
155351668	Use in psychotherapy	1	10	8	2546	03/09/07 05:07	18	uses	positive
155351668	Health Risks	1	13	5	7727	03/09/07 05:07	18	safety	negative
162208409	Effects	1	2	8	160	04/10/07 09:56	10	effects	neutral
162208409	Subjective effects	2	3	7	1283	04/10/07 09:56	10	effects	neutral
162208409	Use in psychotherapy	1	10	0		04/10/07 09:56	10	uses	positive
162215879	Effects	1	2	16	160	04/10/07 11:04	18	effects	neutral
162215879	Subjective effects	2	3	15	1283	04/10/07 11:04	18	effects	neutral
162215879	Use in psychotherapy	1	10	8	2537	04/10/07 11:04	18	uses	positive
162215879	Health Risks	1	13	5	11097	04/10/07 11:04	18	safety	negative
166896796	Effects	1	2	21	160	25/10/07 02:28	23	effects	neutral
166896796	Subjective effects	2	3	20	1135	25/10/07 02:28	23	effects	neutral
166896796	Use in psychotherapy	1	9	14	2746	25/10/07 02:28	23	uses	positive
166896796	Health Risks	1	12	11	18	25/10/07 02:28	23	safety	negative
166896796	Physical	2	13	10	1461	25/10/07 02:28	23	effects	neutral
166896796	Neurological	2	14	9	2667	25/10/07 02:28	23	effects	neutral
166896796	Psychological	2	15	8	3067	25/10/07 02:28	23	effects	neutral
168533028	Effects	1	2	22	160	01/11/07 16:35	24	effects	neutral
168533028	Subjective effects	2	3	21	1135	01/11/07 16:35	24	effects	neutral
168533028	Use in psychotherapy	1	10	14	2746	01/11/07 16:35	24	uses	positive
168533028	Health Risks	1	13	11	18	01/11/07 16:35	24	safety	negative
168533028	Physical	2	14	10	1461	01/11/07 16:35	24	effects	neutral
168533028	Neurological	2	15	9	3761	01/11/07 16:35	24	effects	neutral
168533270	Effects	1	2	22	160	01/11/07 16:37	24	effects	neutral
168533270	Subjective effects	2	3	21	1135	01/11/07 16:37	24	effects	neutral
168533270	Use in psychotherapy	1	10	14	2746	01/11/07 16:37	24	uses	positive
168533270	Health Risks	1	13	11	18	01/11/07 16:37	24	safety	negative
168533270	Physical	2	14	10	1461	01/11/07 16:37	24	effects	neutral
168533270	Neurological	2	15	9	2688	01/11/07 16:37	24	effects	neutral
168533270	Psychological	2	16	8	3022	01/11/07 16:37	24	effects	neutral
168537773	Effects	1	2	22	160	01/11/07 17:00	24	effects	neutral
168537773	Subjective effects	2	3	21	1135	01/11/07 17:00	24	effects	neutral
168537773	Use in psychotherapy	1	10	14	2746	01/11/07 17:00	24	uses	positive
168537773	Physical	2	14	10	1461	01/11/07 17:00	24	effects	neutral
168537773	Neurological	2	15	9	6115	01/11/07 17:00	24	effects	neutral
168537773	Psychological	2	16	8	3022	01/11/07 17:00	24	effects	neutral
168537773	Health Concerns And Facts	1	13	11	31	01/11/07 17:00	24	safety	negative
172157964	Effects	1	2	26	160	17/11/07 22:02	28	effects	neutral
172157964	Subjective effects	2	4	24	1135	17/11/07 22:02	28	effects	neutral
172157964	Use in psychotherapy	1	11	17	2746	17/11/07 22:02	28	uses	positive
172157964	Physical	2	15	13	1461	17/11/07 22:02	28	effects	neutral
172157964	Psychological	2	19	9	1817	17/11/07 22:02	28	effects	neutral
172157964	Health Concerns And Facts	1	14	14	1234	17/11/07 22:02	28	safety	negative
172959866	Effects	1	2	26	160	21/11/07 19:21	28	effects	neutral
172959866	Subjective effects	2	4	24	1135	21/11/07 19:21	28	effects	neutral
172959866	Use in psychotherapy	1	11	17	2746	21/11/07 19:21	28	uses	positive
172959866	Physical	2	15	13	1461	21/11/07 19:21	28	effects	neutral
172959866	Psychological	2	19	9	2500	21/11/07 19:21	28	effects	neutral
172959866	Health Concerns	1	14	14	1208	21/11/07 19:21	28	safety	negative
173246195	Effects	1	2	27	160	23/11/07 08:10	29	effects	neutral
173246195	Subjective effects	2	4	25	1135	23/11/07 08:10	29	effects	neutral
173246195	Use in psychotherapy	1	11	18	2746	23/11/07 08:10	29	uses	positive
173246195	Physical	2	16	13	1461	23/11/07 08:10	29	effects	neutral
173246195	Psychological	2	20	9	2500	23/11/07 08:10	29	effects	neutral
173246195	Health Concerns	1	14	15	298	23/11/07 08:10	29	safety	negative
173246195	Neurotoxicity	2	19	10	5860	23/11/07 08:10	29	effects	negative
173323193	Effects	1	2	27	160	23/11/07 18:37	29	effects	neutral
173323193	Subjective effects	2	4	25	1135	23/11/07 18:37	29	effects	neutral
173323193	Use in psychotherapy	1	11	18	2746	23/11/07 18:37	29	uses	positive
173323193	Physical	2	16	13	1507	23/11/07 18:37	29	effects	neutral
173323193	Psychological	2	20	9	2500	23/11/07 18:37	29	effects	neutral
173323193	Neurotoxicity	2	19	10	5860	23/11/07 18:37	29	effects	negative
173323193	Health concerns	1	14	15	298	23/11/07 18:37	29	safety	negative
173323193	Neurological overview	2	17	12	2472	23/11/07 18:37	29	effects	neutral
176024589	Use in psychotherapy	1	8	18	2752	05/12/07 22:25	26	uses	positive
176024589	Physical	2	13	13	1544	05/12/07 22:25	26	effects	neutral
176024589	Psychological	2	17	9	2774	05/12/07 22:25	26	effects	neutral
176024589	Neurotoxicity	2	16	10	6334	05/12/07 22:25	26	effects	negative
176024589	Health concerns	1	11	15	298	05/12/07 22:25	26	safety	negative
176024589	Neurological overview	2	14	12	2480	05/12/07 22:25	26	effects	neutral
176062121	Effects	1	2	27	160	06/12/07 01:41	29	effects	neutral
176062121	Subjective effects	2	4	25	1135	06/12/07 01:41	29	effects	neutral
176062121	Use in psychotherapy	1	11	18	2752	06/12/07 01:41	29	uses	positive
176062121	Physical	2	16	13	1544	06/12/07 01:41	29	effects	neutral
176062121	Psychological	2	20	9	2774	06/12/07 01:41	29	effects	neutral
176062121	Neurotoxicity	2	19	10	6334	06/12/07 01:41	29	effects	negative
176062121	Health concerns	1	14	15	298	06/12/07 01:41	29	safety	negative
176062121	Neurological overview	2	17	12	2480	06/12/07 01:41	29	effects	neutral
184695029	Effects	1	2	26	160	16/01/08 09:20	28	effects	neutral
184695029	Use in psychotherapy	1	10	18	2752	16/01/08 09:20	28	uses	positive
184695029	Physical	2	15	13	1531	16/01/08 09:20	28	effects	neutral
184695029	Psychological	2	19	9	2774	16/01/08 09:20	28	effects	neutral
184695029	Neurotoxicity	2	18	10	6308	16/01/08 09:20	28	effects	negative
184695029	Health concerns	1	13	15	298	16/01/08 09:20	28	safety	negative
184695029	Neurological overview	2	16	12	2471	16/01/08 09:20	28	effects	neutral
184695040	Effects	1	2	27	160	16/01/08 09:20	29	effects	neutral
184695040	Subjective effects	2	4	25	1359	16/01/08 09:20	29	effects	neutral
184695040	Use in psychotherapy	1	11	18	2752	16/01/08 09:20	29	uses	positive
184695040	Physical	2	16	13	1531	16/01/08 09:20	29	effects	neutral
184695040	Psychological	2	20	9	2774	16/01/08 09:20	29	effects	neutral
184695040	Neurotoxicity	2	19	10	6308	16/01/08 09:20	29	effects	negative
184695040	Health concerns	1	14	15	298	16/01/08 09:20	29	safety	negative
184695040	Neurological overview	2	17	12	2471	16/01/08 09:20	29	effects	neutral
184937509	Use in psychotherapy	1	8	18	2752	17/01/08 08:46	26	uses	positive
184937509	Physical	2	13	13	1531	17/01/08 08:46	26	effects	neutral
184937509	Psychological	2	17	9	2774	17/01/08 08:46	26	effects	neutral
184937509	Neurotoxicity	2	16	10	6308	17/01/08 08:46	26	effects	negative
184937509	Health concerns	1	11	15	298	17/01/08 08:46	26	safety	negative
184937509	Neurological overview	2	14	12	2471	17/01/08 08:46	26	effects	neutral
184942104	Effects	1	2	27	160	17/01/08 09:36	29	effects	neutral
184942104	Subjective effects	2	4	25	1359	17/01/08 09:36	29	effects	neutral
184942104	Use in psychotherapy	1	11	18	2752	17/01/08 09:36	29	uses	positive
184942104	Physical	2	16	13	1531	17/01/08 09:36	29	effects	neutral
184942104	Psychological	2	20	9	2774	17/01/08 09:36	29	effects	neutral
184942104	Neurotoxicity	2	19	10	6308	17/01/08 09:36	29	effects	negative
184942104	Health concerns	1	14	15	298	17/01/08 09:36	29	safety	negative
184942104	Neurological overview	2	17	12	2471	17/01/08 09:36	29	effects	neutral
191521158	Use in psychotherapy	1	5	18	2866	14/02/08 22:54	23	uses	positive
191521158	Physical	2	10	13	1531	14/02/08 22:54	23	effects	neutral
191521158	Psychological	2	14	9	3619	14/02/08 22:54	23	effects	neutral
191521158	Neurotoxicity	2	13	10	6308	14/02/08 22:54	23	effects	negative
191521158	Health concerns	1	8	15	270	14/02/08 22:54	23	safety	negative
191521158	Neurological overview	2	11	12	2471	14/02/08 22:54	23	effects	neutral
191521175	Effects	1	2	27	160	14/02/08 22:54	29	effects	neutral
191521175	Subjective effects	2	4	25	1494	14/02/08 22:54	29	effects	neutral
191521175	Use in psychotherapy	1	11	18	2866	14/02/08 22:54	29	uses	positive
191521175	Physical	2	16	13	1531	14/02/08 22:54	29	effects	neutral
191521175	Psychological	2	20	9	3619	14/02/08 22:54	29	effects	neutral
191521175	Neurotoxicity	2	19	10	6308	14/02/08 22:54	29	effects	negative
191521175	Health concerns	1	14	15	270	14/02/08 22:54	29	safety	negative
191521175	Neurological overview	2	17	12	2471	14/02/08 22:54	29	effects	neutral
199975415	Use in psychotherapy	1	7	18	1687	22/03/08 01:57	25	uses	positive
199975415	Physical	2	12	13	1599	22/03/08 01:57	25	effects	neutral
199975415	Psychological	2	16	9	2407	22/03/08 01:57	25	effects	neutral
199975415	Neurotoxicity	2	15	10	6364	22/03/08 01:57	25	effects	negative
199975415	Health concerns	1	10	15	270	22/03/08 01:57	25	safety	negative
199975415	Neurological overview	2	13	12	2471	22/03/08 01:57	25	effects	neutral
199977092	Effects	1	2	26	114	22/03/08 02:07	28	effects	neutral
199977092	Subjective effects	2	4	24	2180	22/03/08 02:07	28	effects	neutral
199977092	Use in psychotherapy	1	10	18	1687	22/03/08 02:07	28	uses	positive
199977092	Physical	2	15	13	1599	22/03/08 02:07	28	effects	neutral
199977092	Psychological	2	19	9	2407	22/03/08 02:07	28	effects	neutral
199977092	Neurotoxicity	2	18	10	6364	22/03/08 02:07	28	effects	negative
199977092	Health concerns	1	13	15	270	22/03/08 02:07	28	safety	negative
199977092	Neurological overview	2	16	12	2471	22/03/08 02:07	28	effects	neutral
204062539	Effects	1	2	27	13	07/04/08 20:23	29	effects	neutral
204062539	Subjective effects	2	4	25	2178	07/04/08 20:23	29	effects	neutral
204062539	Long-term effects	2	5	24	1784	07/04/08 20:23	29	effects	neutral
204062539	Use in psychotherapy	1	11	18	1688	07/04/08 20:23	29	uses	positive
204062539	Physical	2	16	13	1657	07/04/08 20:23	29	effects	neutral
204062539	Psychological	2	20	9	2407	07/04/08 20:23	29	effects	neutral
204062539	Neurotoxicity	2	19	10	6029	07/04/08 20:23	29	effects	negative
204062539	Health concerns	1	14	15	268	07/04/08 20:23	29	safety	negative
204062539	Neurological overview	2	17	12	2471	07/04/08 20:23	29	effects	neutral
206735219	Effects	1	2	27	12	19/04/08 18:38	29	effects	neutral
206735219	Long-term effects	2	5	24	2610	19/04/08 18:38	29	effects	neutral
206735219	Use in psychotherapy	1	11	18	2856	19/04/08 18:38	29	uses	positive
206735219	Physical	2	16	13	1790	19/04/08 18:38	29	effects	neutral
206735219	Psychological	2	20	9	2573	19/04/08 18:38	29	effects	neutral
206735219	Neurotoxicity	2	19	10	4855	19/04/08 18:38	29	effects	negative
206735219	Health concerns	1	14	15	259	19/04/08 18:38	29	safety	negative
206735219	Neurological overview	2	17	12	3064	19/04/08 18:38	29	effects	neutral
206735219	Short-term effects	2	4	25	2197	19/04/08 18:38	29	effects	neutral
209080490	Long-term effects	2	4	24	2610	29/04/08 20:48	28	effects	neutral
209080490	Use in psychotherapy	1	10	18	2856	29/04/08 20:48	28	uses	positive
209080490	Physical	2	15	13	1790	29/04/08 20:48	28	effects	neutral
209080490	Psychological	2	19	9	2573	29/04/08 20:48	28	effects	neutral
209080490	Neurotoxicity	2	18	10	4876	29/04/08 20:48	28	effects	negative
209080490	Health concerns	1	13	15	259	29/04/08 20:48	28	safety	negative
209080490	Neurological overview	2	16	12	3064	29/04/08 20:48	28	effects	neutral
209080490	Short-term effects	2	3	25	2214	29/04/08 20:48	28	effects	neutral
209081054	Effects	1	2	27	12	29/04/08 20:51	29	effects	neutral
209081054	Long-term effects	2	5	24	2610	29/04/08 20:51	29	effects	neutral
209081054	Use in psychotherapy	1	11	18	2856	29/04/08 20:51	29	uses	positive
209081054	Physical	2	16	13	1790	29/04/08 20:51	29	effects	neutral
209081054	Psychological	2	20	9	2573	29/04/08 20:51	29	effects	neutral
209081054	Neurotoxicity	2	19	10	4876	29/04/08 20:51	29	effects	negative
209081054	Health concerns	1	14	15	259	29/04/08 20:51	29	safety	negative
209081054	Neurological overview	2	17	12	3064	29/04/08 20:51	29	effects	neutral
209081054	Short-term effects	2	4	25	2214	29/04/08 20:51	29	effects	neutral
213543347	Effects	1	2	26	12	19/05/08 20:20	28	effects	neutral
213543347	Long-term effects	2	5	23	2610	19/05/08 20:20	28	effects	neutral
213543347	Use in psychotherapy	1	11	17	2856	19/05/08 20:20	28	uses	positive
213543347	Physical	2	16	12	1790	19/05/08 20:20	28	effects	neutral
213543347	Neurotoxicity	2	19	9	4892	19/05/08 20:20	28	effects	negative
213543347	Health concerns	1	14	14	259	19/05/08 20:20	28	safety	negative
213543347	Neurological overview	2	17	11	3064	19/05/08 20:20	28	effects	neutral
213543347	Short-term effects	2	4	24	2199	19/05/08 20:20	28	effects	neutral
213543399	Effects	1	2	27	12	19/05/08 20:20	29	effects	neutral
213543399	Long-term effects	2	5	24	2610	19/05/08 20:20	29	effects	neutral
213543399	Use in psychotherapy	1	11	18	2856	19/05/08 20:20	29	uses	positive
213543399	Physical	2	16	13	1790	19/05/08 20:20	29	effects	neutral
213543399	Psychological	2	20	9	2573	19/05/08 20:20	29	effects	neutral
213543399	Neurotoxicity	2	19	10	4876	19/05/08 20:20	29	effects	negative
213543399	Health concerns	1	14	15	259	19/05/08 20:20	29	safety	negative
213543399	Neurological overview	2	17	12	3064	19/05/08 20:20	29	effects	neutral
213543399	Short-term effects	2	4	25	2199	19/05/08 20:20	29	effects	neutral
214126604	Effects	1	2	26	12	22/05/08 05:36	28	effects	neutral
214126604	Long-term effects	2	4	24	2610	22/05/08 05:36	28	effects	neutral
214126604	Use in psychotherapy	1	10	18	2856	22/05/08 05:36	28	uses	positive
214126604	Physical	2	15	13	1790	22/05/08 05:36	28	effects	neutral
214126604	Psychological	2	19	9	2573	22/05/08 05:36	28	effects	neutral
214126604	Neurotoxicity	2	18	10	4876	22/05/08 05:36	28	effects	negative
214126604	Health concerns	1	13	15	259	22/05/08 05:36	28	safety	negative
214126604	Neurological overview	2	16	12	3064	22/05/08 05:36	28	effects	neutral
214126619	Effects	1	2	27	12	22/05/08 05:36	29	effects	neutral
214126619	Long-term effects	2	5	24	2610	22/05/08 05:36	29	effects	neutral
214126619	Use in psychotherapy	1	11	18	2856	22/05/08 05:36	29	uses	positive
214126619	Physical	2	16	13	1790	22/05/08 05:36	29	effects	neutral
214126619	Psychological	2	20	9	2573	22/05/08 05:36	29	effects	neutral
214126619	Neurotoxicity	2	19	10	4876	22/05/08 05:36	29	effects	negative
214126619	Health concerns	1	14	15	259	22/05/08 05:36	29	safety	negative
214126619	Neurological overview	2	17	12	3064	22/05/08 05:36	29	effects	neutral
214126619	Short-term effects	2	4	25	2199	22/05/08 05:36	29	effects	neutral
214616479	Effects	1	2	27	12	24/05/08 12:20	29	effects	neutral
214616479	Use in psychotherapy	1	11	18	2856	24/05/08 12:20	29	uses	positive
214616479	Physical	2	16	13	1790	24/05/08 12:20	29	effects	neutral
214616479	Psychological	2	20	9	2573	24/05/08 12:20	29	effects	neutral
214616479	Neurotoxicity	2	19	10	4876	24/05/08 12:20	29	effects	negative
214616479	Health concerns	1	14	15	259	24/05/08 12:20	29	safety	negative
214616479	Neurological overview	2	17	12	3064	24/05/08 12:20	29	effects	neutral
214616479	Short-term effects	2	4	25	2203	24/05/08 12:20	29	effects	neutral
214616479	Effects of chronic use	2	5	24	2615	24/05/08 12:20	29	effects	neutral
214616894	Effects	1	2	27	12	24/05/08 12:24	29	effects	neutral
214616894	Use in psychotherapy	1	11	18	2856	24/05/08 12:24	29	uses	positive
214616894	Physical	2	16	13	1790	24/05/08 12:24	29	effects	neutral
214616894	Psychological	2	20	9	2573	24/05/08 12:24	29	effects	neutral
214616894	Neurotoxicity	2	19	10	4876	24/05/08 12:24	29	effects	negative
214616894	Health concerns	1	14	15	259	24/05/08 12:24	29	safety	negative
214616894	Neurological overview	2	17	12	3064	24/05/08 12:24	29	effects	neutral
214616894	Effects of chronic use	2	5	24	2615	24/05/08 12:24	29	effects	neutral
214616894	Acute effects	2	4	25	2198	24/05/08 12:24	29	effects	negative
215609956	Effects	1	2	28	12	28/05/08 23:03	30	effects	neutral
215609956	Use in psychotherapy	2	12	18	3199	28/05/08 23:03	30	uses	positive
215609956	Physical	3	17	13	2415	28/05/08 23:03	30	effects	neutral
215609956	Psychological	3	21	9	2573	28/05/08 23:03	30	effects	neutral
215609956	Neurotoxicity	3	20	10	4872	28/05/08 23:03	30	effects	negative
215609956	Health concerns	2	15	15	259	28/05/08 23:03	30	safety	negative
215609956	Neurological overview	3	18	12	3065	28/05/08 23:03	30	effects	neutral
215609956	Effects of chronic use	2	5	25	2615	28/05/08 23:03	30	effects	neutral
215609956	Acute effects	2	4	26	2198	28/05/08 23:03	30	effects	negative
215609956	Controversy surrounding research	1	6	24	5849	28/05/08 23:03	30	research	neutral
222996639	Effects	1	2	26	12	02/07/08 02:42	28	effects	neutral
222996639	Physical	2	15	13	2411	02/07/08 02:42	28	effects	neutral
222996639	Psychological	2	19	9	2600	02/07/08 02:42	28	effects	neutral
222996639	Neurotoxicity	2	18	10	4835	02/07/08 02:42	28	effects	negative
222996639	Health concerns	1	13	15	259	02/07/08 02:42	28	safety	negative
222996639	Neurological overview	2	16	12	3060	02/07/08 02:42	28	effects	neutral
222996639	Effects of chronic use	2	5	23	3299	02/07/08 02:42	28	effects	neutral
222996639	Acute effects	2	4	24	2226	02/07/08 02:42	28	effects	negative
222996639	Controversy surrounding research	2	6	22	5307	02/07/08 02:42	28	research	neutral
222996752	Effects	1	2	27	12	02/07/08 02:43	29	effects	neutral
222996752	Use in psychotherapy	1	11	18	5192	02/07/08 02:43	29	uses	positive
222996752	Physical	2	16	13	2411	02/07/08 02:43	29	effects	neutral
222996752	Psychological	2	20	9	2600	02/07/08 02:43	29	effects	neutral
222996752	Neurotoxicity	2	19	10	4835	02/07/08 02:43	29	effects	negative
222996752	Health concerns	1	14	15	259	02/07/08 02:43	29	safety	negative
222996752	Neurological overview	2	17	12	3060	02/07/08 02:43	29	effects	neutral
222996752	Effects of chronic use	2	5	24	3299	02/07/08 02:43	29	effects	neutral
222996752	Acute effects	2	4	25	2226	02/07/08 02:43	29	effects	negative
222996752	Controversy surrounding research	2	6	23	5307	02/07/08 02:43	29	research	neutral
222996904	Effects	1	2	26	12	02/07/08 02:44	28	effects	neutral
222996904	Physical	2	15	13	2411	02/07/08 02:44	28	effects	neutral
222996904	Psychological	2	19	9	2600	02/07/08 02:44	28	effects	neutral
222996904	Neurotoxicity	2	18	10	4835	02/07/08 02:44	28	effects	negative
222996904	Health concerns	1	13	15	259	02/07/08 02:44	28	safety	negative
222996904	Neurological overview	2	16	12	3060	02/07/08 02:44	28	effects	neutral
222996904	Effects of chronic use	2	5	23	3299	02/07/08 02:44	28	effects	neutral
222996904	Acute effects	2	4	24	2226	02/07/08 02:44	28	effects	negative
222996904	Controversy surrounding research	2	6	22	5307	02/07/08 02:44	28	research	neutral
222996924	Effects	1	2	27	12	02/07/08 02:45	29	effects	neutral
222996924	Use in psychotherapy	1	11	18	5192	02/07/08 02:45	29	uses	positive
222996924	Physical	2	16	13	2411	02/07/08 02:45	29	effects	neutral
222996924	Psychological	2	20	9	2600	02/07/08 02:45	29	effects	neutral
222996924	Neurotoxicity	2	19	10	4835	02/07/08 02:45	29	effects	negative
222996924	Health concerns	1	14	15	259	02/07/08 02:45	29	safety	negative
222996924	Neurological overview	2	17	12	3060	02/07/08 02:45	29	effects	neutral
222996924	Effects of chronic use	2	5	24	3299	02/07/08 02:45	29	effects	neutral
222996924	Acute effects	2	4	25	2226	02/07/08 02:45	29	effects	negative
222996924	Controversy surrounding research	2	6	23	5307	02/07/08 02:45	29	research	neutral
222997047	Effects	1	2	26	12	02/07/08 02:45	28	effects	neutral
222997047	Physical	2	15	13	2411	02/07/08 02:45	28	effects	neutral
222997047	Psychological	2	19	9	2600	02/07/08 02:45	28	effects	neutral
222997047	Neurotoxicity	2	18	10	4835	02/07/08 02:45	28	effects	negative
222997047	Health concerns	1	13	15	259	02/07/08 02:45	28	safety	negative
222997047	Neurological overview	2	16	12	3060	02/07/08 02:45	28	effects	neutral
222997047	Effects of chronic use	2	5	23	3299	02/07/08 02:45	28	effects	neutral
222997047	Acute effects	2	4	24	2226	02/07/08 02:45	28	effects	negative
222997047	Controversy surrounding research	2	6	22	5307	02/07/08 02:45	28	research	neutral
222997077	Effects	1	2	27	12	02/07/08 02:46	29	effects	neutral
222997077	Use in psychotherapy	1	11	18	5192	02/07/08 02:46	29	uses	positive
222997077	Physical	2	16	13	2411	02/07/08 02:46	29	effects	neutral
222997077	Psychological	2	20	9	2600	02/07/08 02:46	29	effects	neutral
222997077	Neurotoxicity	2	19	10	4835	02/07/08 02:46	29	effects	negative
222997077	Health concerns	1	14	15	259	02/07/08 02:46	29	safety	negative
222997077	Neurological overview	2	17	12	3060	02/07/08 02:46	29	effects	neutral
222997077	Effects of chronic use	2	5	24	3299	02/07/08 02:46	29	effects	neutral
222997077	Acute effects	2	4	25	2226	02/07/08 02:46	29	effects	negative
222997077	Controversy surrounding research	2	6	23	5307	02/07/08 02:46	29	research	neutral
224979328	Effects	1	2	27	12	11/07/08 08:07	29	effects	neutral
224979328	Use in psychotherapy	1	11	18	5200	11/07/08 08:07	29	uses	positive
224979328	Physical	2	16	13	2411	11/07/08 08:07	29	effects	neutral
224979328	Psychological	2	20	9	2600	11/07/08 08:07	29	effects	neutral
224979328	Neurotoxicity	2	19	10	4835	11/07/08 08:07	29	effects	negative
224979328	Health concerns	1	14	15	259	11/07/08 08:07	29	safety	negative
224979328	Neurological overview	2	17	12	2881	11/07/08 08:07	29	effects	neutral
224979328	Effects of chronic use	2	5	24	8644	11/07/08 08:07	29	effects	neutral
224979328	Acute effects	2	4	25	2264	11/07/08 08:07	29	effects	negative
224979341	Effects	1	2	28	12	11/07/08 08:07	30	effects	neutral
224979341	Use in psychotherapy	1	12	18	5200	11/07/08 08:07	30	uses	positive
224979341	Physical	2	17	13	2411	11/07/08 08:07	30	effects	neutral
224979341	Psychological	2	21	9	2600	11/07/08 08:07	30	effects	neutral
224979341	Neurotoxicity	2	20	10	4835	11/07/08 08:07	30	effects	negative
224979341	Health concerns	1	15	15	259	11/07/08 08:07	30	safety	negative
224979341	Neurological overview	2	18	12	2881	11/07/08 08:07	30	effects	neutral
224979341	Effects of chronic use	2	5	25	3299	11/07/08 08:07	30	effects	neutral
224979341	Acute effects	2	4	26	2264	11/07/08 08:07	30	effects	negative
224979341	Controversy surrounding research	2	6	24	5307	11/07/08 08:07	30	research	neutral
226149190	Effects	1	2	27	12	17/07/08 01:17	29	effects	neutral
226149190	Use in psychotherapy	1	12	17	5200	17/07/08 01:17	29	uses	positive
226149190	Physical	2	17	12	2413	17/07/08 01:17	29	effects	neutral
226149190	Psychological	2	20	9	2571	17/07/08 01:17	29	effects	neutral
226149190	Neurotoxicity	2	19	10	4835	17/07/08 01:17	29	effects	negative
226149190	Health concerns	1	15	14	259	17/07/08 01:17	29	safety	negative
226149190	Effects of chronic use	2	5	24	3299	17/07/08 01:17	29	effects	neutral
226149190	Acute effects	2	4	25	2264	17/07/08 01:17	29	effects	negative
226149190	Controversy surrounding research	2	6	23	5307	17/07/08 01:17	29	research	neutral
226189822	Effects	1	2	28	12	17/07/08 06:45	30	effects	neutral
226189822	Use in psychotherapy	1	12	18	5200	17/07/08 06:45	30	uses	positive
226189822	Physical	2	17	13	2411	17/07/08 06:45	30	effects	neutral
226189822	Psychological	2	21	9	2571	17/07/08 06:45	30	effects	neutral
226189822	Neurotoxicity	2	20	10	4835	17/07/08 06:45	30	effects	negative
226189822	Health concerns	1	15	15	259	17/07/08 06:45	30	safety	negative
226189822	Neurological overview	2	18	12	2881	17/07/08 06:45	30	effects	neutral
226189822	Effects of chronic use	2	5	25	3299	17/07/08 06:45	30	effects	neutral
226189822	Acute effects	2	4	26	2264	17/07/08 06:45	30	effects	negative
226189822	Controversy surrounding research	2	6	24	5307	17/07/08 06:45	30	research	neutral
227709959	Effects	1	2	20	12	24/07/08 21:50	22	effects	neutral
227709959	Use in psychotherapy	1	12	10	5196	24/07/08 21:50	22	uses	positive
227709959	Health concerns	1	15	7	8477	24/07/08 21:50	22	safety	negative
227709959	Effects of chronic use	2	5	17	3299	24/07/08 21:50	22	effects	neutral
227709959	Acute effects	2	4	18	2264	24/07/08 21:50	22	effects	negative
227709959	Controversy surrounding research	2	6	16	5331	24/07/08 21:50	22	research	neutral
227711347	Effects	1	3	18	13	24/07/08 21:59	21	effects	neutral
227711347	Use in psychotherapy	1	11	10	5196	24/07/08 21:59	21	uses	positive
227711347	Health concerns	1	14	7	8477	24/07/08 21:59	21	safety	negative
227711347	Effects of chronic use	2	5	16	3300	24/07/08 21:59	21	effects	neutral
227711347	Acute effects	2	4	17	2264	24/07/08 21:59	21	effects	negative
227713038	Effects	1	4	13	13	24/07/08 22:10	17	effects	neutral
227713038	Health concerns	1	10	7	8477	24/07/08 22:10	17	safety	negative
227713038	Effects of chronic use	2	6	11	3300	24/07/08 22:10	17	effects	neutral
227713038	Acute effects	2	5	12	2264	24/07/08 22:10	17	effects	negative
227713038	Theraputic Uses	1	2	15	5191	24/07/08 22:10	17	uses	positive
227957775	Effects	1	4	13	13	26/07/08 04:53	17	effects	neutral
227957775	Health concerns	1	10	7	8477	26/07/08 04:53	17	safety	negative
227957775	Effects of chronic use	2	6	11	3300	26/07/08 04:53	17	effects	neutral
227957775	Acute effects	2	5	12	2264	26/07/08 04:53	17	effects	negative
227957775	Therapeutic Uses	1	2	15	5192	26/07/08 04:53	17	uses	positive
230840140	Effects	1	4	13	37	09/08/08 17:06	17	effects	neutral
230840140	Health concerns	1	10	7	8478	09/08/08 17:06	17	safety	negative
230840140	Effects of chronic use	2	6	11	3299	09/08/08 17:06	17	effects	neutral
230840140	Acute effects	2	5	12	2257	09/08/08 17:06	17	effects	negative
230840140	Therapeutic uses	1	2	15	5227	09/08/08 17:06	17	uses	positive
240546163	Effects	1	3	13	12	23/09/08 22:17	16	effects	neutral
240546163	Health concerns	1	9	7	8573	23/09/08 22:17	16	safety	negative
240546163	Effects of chronic use	2	5	11	3315	23/09/08 22:17	16	effects	neutral
240546163	Acute effects	2	4	12	2277	23/09/08 22:17	16	effects	negative
240546187	Effects	1	4	13	12	23/09/08 22:17	17	effects	neutral
240546187	Health concerns	1	10	7	8573	23/09/08 22:17	17	safety	negative
240546187	Effects of chronic use	2	6	11	3315	23/09/08 22:17	17	effects	neutral
240546187	Acute effects	2	5	12	2277	23/09/08 22:17	17	effects	negative
240546187	Therapeutic uses	1	2	15	5227	23/09/08 22:17	17	uses	positive
241687440	Effects	1	4	14	12	29/09/08 03:07	18	effects	neutral
241687440	Health concerns	1	10	8	8574	29/09/08 03:07	18	safety	negative
241687440	Effects of chronic use	2	6	12	3315	29/09/08 03:07	18	effects	neutral
241687440	Acute effects	2	5	13	2277	29/09/08 03:07	18	effects	negative
241687495	Effects	1	4	14	12	29/09/08 03:07	18	effects	neutral
241687495	Health concerns	1	10	8	8574	29/09/08 03:07	18	safety	negative
241687495	Effects of chronic use	2	6	12	3315	29/09/08 03:07	18	effects	neutral
241687495	Acute effects	2	5	13	2277	29/09/08 03:07	18	effects	negative
241687495	Therapeutic uses	1	2	16	5227	29/09/08 03:07	18	uses	positive
270150184	Health concerns	1	6	8	10768	12/02/09 03:37	14	safety	negative
270150184	Therapeutic uses	1	2	12	3510	12/02/09 03:37	14	uses	positive
270150209	Effects	1	4	14	12	12/02/09 03:38	18	effects	neutral
270150209	Health concerns	1	10	8	10768	12/02/09 03:38	18	safety	negative
270150209	Effects of chronic use	2	6	12	3885	12/02/09 03:38	18	effects	neutral
270150209	Acute effects	2	5	13	2261	12/02/09 03:38	18	effects	negative
270150209	Therapeutic uses	1	2	16	5583	12/02/09 03:38	18	uses	positive
270315615	Effects	1	4	12	12	12/02/09 22:35	16	effects	neutral
270315615	Effects of chronic use	2	6	10	4001	12/02/09 22:35	16	effects	neutral
270315615	Acute effects	2	5	11	2261	12/02/09 22:35	16	effects	negative
270315615	Therapeutic uses	1	2	14	5583	12/02/09 22:35	16	uses	positive
270315654	Effects	1	4	14	12	12/02/09 22:35	18	effects	neutral
270315654	Health concerns	1	10	8	10768	12/02/09 22:35	18	safety	negative
270315654	Effects of chronic use	2	6	12	4001	12/02/09 22:35	18	effects	neutral
270315654	Acute effects	2	5	13	2261	12/02/09 22:35	18	effects	negative
270315654	Therapeutic uses	1	2	16	5583	12/02/09 22:35	18	uses	positive
270890548	Effects	1	4	14	12	15/02/09 14:09	18	effects	neutral
270890548	Health concerns	1	10	8	10768	15/02/09 14:09	18	safety	negative
270890548	Effects of chronic use	2	6	12	4001	15/02/09 14:09	18	effects	neutral
270890548	Therapeutic uses	1	2	16	5583	15/02/09 14:09	18	uses	positive
270890548	Acute Non-Fatal effects	2	5	13	2406	15/02/09 14:09	18	effects	neutral
271095232	Effects	1	4	14	12	16/02/09 11:06	18	effects	neutral
271095232	Health concerns	1	10	8	10768	16/02/09 11:06	18	safety	negative
271095232	Effects of chronic use	2	6	12	4001	16/02/09 11:06	18	effects	neutral
271095232	Acute effects	2	5	13	2261	16/02/09 11:06	18	effects	negative
271095232	Therapeutic uses	1	2	16	5583	16/02/09 11:06	18	uses	positive
272345906	Effects	1	4	15	12	21/02/09 21:25	19	effects	neutral
272345906	Health concerns	1	11	8	10888	21/02/09 21:25	19	safety	negative
272345906	Effects of chronic use	2	6	13	4101	21/02/09 21:25	19	effects	neutral
272345906	Therapeutic uses	1	2	17	5583	21/02/09 21:25	19	uses	positive
272347100	Effects	1	4	15	12	21/02/09 21:30	19	effects	neutral
272347100	Health concerns	1	11	8	10888	21/02/09 21:30	19	safety	negative
272347100	Effects of chronic use	2	6	13	4101	21/02/09 21:30	19	effects	neutral
272347100	Acute effects	1	5	14	2259	21/02/09 21:30	19	effects	negative
272347100	Therapeutic uses	1	2	17	5583	21/02/09 21:30	19	uses	positive
281872819	Effects	1	4	17	12	05/04/09 10:32	21	effects	neutral
281872819	Health concerns	1	10	11	64	05/04/09 10:32	21	safety	negative
281872819	Acute effects	2	5	16	2312	05/04/09 10:32	21	effects	negative
281872819	Therapeutic uses	1	2	19	3916	05/04/09 10:32	21	uses	positive
281872819	Acute health concerns	2	11	10	1115	05/04/09 10:32	21	safety	neutral
281872819	Effects on the brain and serotonin	2	12	9	7725	05/04/09 10:32	21	effects	neutral
281873121	Effects	1	4	15	12	05/04/09 10:35	19	effects	neutral
281873121	Health concerns	1	11	8	10396	05/04/09 10:35	19	safety	negative
281873121	Effects of chronic use	2	6	13	4101	05/04/09 10:35	19	effects	neutral
281873121	Acute effects	2	5	14	2312	05/04/09 10:35	19	effects	negative
281873121	Therapeutic uses	1	2	17	3728	05/04/09 10:35	19	uses	positive
284049000	Effects	1	4	15	12	15/04/09 19:00	19	effects	neutral
284049000	Health concerns	1	11	8	10396	15/04/09 19:00	19	safety	negative
284049000	Effects of chronic use	2	6	13	3368	15/04/09 19:00	19	effects	neutral
284049000	Acute effects	2	5	14	2355	15/04/09 19:00	19	effects	negative
284049000	Therapeutic uses	1	2	17	3728	15/04/09 19:00	19	uses	positive
284049000	Effects On Driving	1	15	4	3036	15/04/09 19:00	19	effects	negative
284053243	Effects	1	4	14	12	15/04/09 19:24	18	effects	neutral
284053243	Health concerns	1	11	7	10396	15/04/09 19:24	18	safety	negative
284053243	Effects of chronic use	2	6	12	3368	15/04/09 19:24	18	effects	neutral
284053243	Acute effects	2	5	13	2355	15/04/09 19:24	18	effects	negative
284053243	Therapeutic uses	1	2	16	3728	15/04/09 19:24	18	uses	positive
284063947	Effects	1	4	16	12	15/04/09 20:21	20	effects	neutral
284063947	Health concerns	1	11	9	10396	15/04/09 20:21	20	safety	negative
284063947	Effects of chronic use	2	6	14	3368	15/04/09 20:21	20	effects	neutral
284063947	Acute effects	2	5	15	2355	15/04/09 20:21	20	effects	negative
284063947	Therapeutic uses	1	2	18	3728	15/04/09 20:21	20	uses	positive
284063947	Effects on Driving	1	15	5	3020	15/04/09 20:21	20	effects	negative
284071702	Effects	1	4	15	12	15/04/09 21:00	19	effects	neutral
284071702	Health concerns	1	11	8	10396	15/04/09 21:00	19	safety	negative
284071702	Effects of chronic use	2	6	13	3368	15/04/09 21:00	19	effects	neutral
284071702	Acute effects	2	5	14	2355	15/04/09 21:00	19	effects	negative
284071702	Therapeutic uses	1	2	17	3728	15/04/09 21:00	19	uses	positive
303801330	Effects	1	9	9	15	23/07/09 20:11	18	effects	neutral
303801330	Health concerns	1	14	4	10409	23/07/09 20:11	18	safety	negative
303801330	Effects of chronic use	2	11	7	3371	23/07/09 20:11	18	effects	neutral
303801330	Acute effects	2	10	8	5721	23/07/09 20:11	18	effects	negative
303801330	Therapeutic use	1	2	16	4303	23/07/09 20:11	18	uses	positive
303806522	Effects	1	10	11	890	23/07/09 20:38	21	effects	neutral
303806522	Health concerns	1	17	4	10409	23/07/09 20:38	21	safety	negative
303806522	Effects of chronic use	2	15	6	3371	23/07/09 20:38	21	effects	neutral
303806522	Therapeutic use	1	2	19	4303	23/07/09 20:38	21	uses	positive
303806522	Beneficial effects	2	11	10	2048	23/07/09 20:38	21	effects	positive
303806522	Side effects	2	12	9	1652	23/07/09 20:38	21	effects	negative
303806522	Rebound / withdrawal	2	13	8	894	23/07/09 20:38	21	safety	negative
303806522	Overdose	2	14	7	2473	23/07/09 20:38	21	effects	negative
303809526	Effects	1	10	11	890	23/07/09 20:54	21	effects	neutral
303809526	Health concerns	1	17	4	10409	23/07/09 20:54	21	safety	negative
303809526	Therapeutic use	1	2	19	4303	23/07/09 20:54	21	uses	positive
303809526	Beneficial effects	2	11	10	2048	23/07/09 20:54	21	effects	positive
303809526	Side effects	2	12	9	1660	23/07/09 20:54	21	effects	negative
303809526	Rebound / withdrawal	2	13	8	1320	23/07/09 20:54	21	safety	negative
303809526	Overdose	2	14	7	2552	23/07/09 20:54	21	effects	negative
303809526	Chronic use	2	15	6	3313	23/07/09 20:54	21	effects	negative
305959298	Effects	1	11	12	886	04/08/09 05:43	23	effects	neutral
305959298	Health concerns	1	18	5	10420	04/08/09 05:43	23	safety	negative
305959298	Therapeutic use	1	3	20	4303	04/08/09 05:43	23	uses	positive
305959298	Beneficial effects	2	12	11	1997	04/08/09 05:43	23	effects	positive
305959298	Side effects	2	13	10	1623	04/08/09 05:43	23	effects	negative
305959298	Rebound / withdrawal	2	14	9	1299	04/08/09 05:43	23	safety	negative
305959298	Overdose	2	15	8	2552	04/08/09 05:43	23	effects	negative
305959298	Chronic use	2	16	7	3313	04/08/09 05:43	23	effects	negative
305959298	Harm assessment	2	19	4	1587	04/08/09 05:43	23	safety	negative
311227572	Effects	1	11	11	886	01/09/09 06:32	22	effects	neutral
311227572	Health concerns	1	18	4	10384	01/09/09 06:32	22	safety	negative
311227572	Therapeutic use	1	3	19	4303	01/09/09 06:32	22	uses	positive
311227572	Beneficial effects	2	12	10	2012	01/09/09 06:32	22	effects	positive
311227572	Side effects	2	13	9	1623	01/09/09 06:32	22	effects	negative
311227572	Rebound / withdrawal	2	14	8	1340	01/09/09 06:32	22	safety	negative
311227572	Overdose	2	15	7	2552	01/09/09 06:32	22	effects	negative
311227572	Chronic use	2	16	6	3795	01/09/09 06:32	22	effects	negative
311247758	Effects	1	11	12	886	01/09/09 09:58	23	effects	neutral
311247758	Health concerns	1	18	5	10384	01/09/09 09:58	23	safety	negative
311247758	Therapeutic use	1	3	20	4303	01/09/09 09:58	23	uses	positive
311247758	Beneficial effects	2	12	11	2012	01/09/09 09:58	23	effects	positive
311247758	Side effects	2	13	10	1623	01/09/09 09:58	23	effects	negative
311247758	Rebound / withdrawal	2	14	9	1340	01/09/09 09:58	23	safety	negative
311247758	Overdose	2	15	8	2552	01/09/09 09:58	23	effects	negative
311247758	Chronic use	2	16	7	3795	01/09/09 09:58	23	effects	negative
311247758	Harm assessment	2	19	4	2106	01/09/09 09:58	23	safety	negative
311461712	Effects	1	11	19	886	02/09/09 12:50	30	effects	neutral
311461712	Health concerns	1	21	9	306	02/09/09 12:50	30	safety	negative
311461712	Therapeutic use	1	3	27	4303	02/09/09 12:50	30	uses	positive
311461712	Beneficial effects	2	12	18	2012	02/09/09 12:50	30	effects	positive
311461712	Side effects	2	13	17	1623	02/09/09 12:50	30	effects	negative
311461712	Rebound / withdrawal	2	14	16	1340	02/09/09 12:50	30	safety	negative
311461712	Overdose	2	15	15	2552	02/09/09 12:50	30	effects	negative
311461712	Chronic use	2	16	14	3795	02/09/09 12:50	30	effects	negative
311461712	Harm assessment	2	25	5	1564	02/09/09 12:50	30	safety	negative
311461712	Short-term health concerns	2	22	8	1537	02/09/09 12:50	30	safety	negative
311461712	Long-term effects on serotonin and dopamine	2	23	7	6979	02/09/09 12:50	30	effects	neutral
313296856	Effects	1	11	19	886	12/09/09 01:57	30	effects	neutral
313296856	Health concerns	1	21	9	306	12/09/09 01:57	30	safety	negative
313296856	Therapeutic use	1	3	27	4303	12/09/09 01:57	30	uses	positive
313296856	Beneficial effects	2	12	18	2012	12/09/09 01:57	30	effects	positive
313296856	Side effects	2	13	17	1623	12/09/09 01:57	30	effects	negative
313296856	Rebound / withdrawal	2	14	16	1340	12/09/09 01:57	30	safety	negative
313296856	Overdose	2	15	15	2552	12/09/09 01:57	30	effects	negative
313296856	Chronic use	2	16	14	3795	12/09/09 01:57	30	effects	negative
313296856	Harm assessment	2	25	5	1564	12/09/09 01:57	30	safety	negative
313296856	Short-term health concerns	2	22	8	1537	12/09/09 01:57	30	safety	negative
313298003	Effects	1	11	19	886	12/09/09 02:06	30	effects	neutral
313298003	Health concerns	1	21	9	306	12/09/09 02:06	30	safety	negative
313298003	Therapeutic use	1	3	27	4303	12/09/09 02:06	30	uses	positive
313298003	Beneficial effects	2	12	18	2012	12/09/09 02:06	30	effects	positive
313298003	Side effects	2	13	17	1623	12/09/09 02:06	30	effects	negative
313298003	Rebound / withdrawal	2	14	16	1340	12/09/09 02:06	30	safety	negative
313298003	Overdose	2	15	15	2552	12/09/09 02:06	30	effects	negative
313298003	Chronic use	2	16	14	3795	12/09/09 02:06	30	effects	negative
313298003	Harm assessment	2	25	5	1564	12/09/09 02:06	30	safety	negative
313298003	Short-term health concerns	2	22	8	1537	12/09/09 02:06	30	safety	negative
313298003	Long-term effects on serotonin and dopamine	2	23	7	6979	12/09/09 02:06	30	effects	neutral
316694056	Health concerns	1	20	9	306	28/09/09 15:09	29	safety	negative
316694056	Therapeutic use	1	3	26	4303	28/09/09 15:09	29	uses	positive
316694056	Beneficial effects	2	11	18	2012	28/09/09 15:09	29	effects	positive
316694056	Side effects	2	12	17	1623	28/09/09 15:09	29	effects	negative
316694056	Rebound / withdrawal	2	13	16	1340	28/09/09 15:09	29	safety	negative
316694056	Overdose	2	14	15	2552	28/09/09 15:09	29	effects	negative
316694056	Chronic use	2	15	14	3795	28/09/09 15:09	29	effects	negative
316694056	Harm assessment	2	24	5	1564	28/09/09 15:09	29	safety	negative
316694056	Short-term health concerns	2	21	8	1537	28/09/09 15:09	29	safety	negative
316694056	Long-term effects on serotonin and dopamine	2	22	7	6870	28/09/09 15:09	29	effects	neutral
316694353	Effects	1	11	19	886	28/09/09 15:11	30	effects	neutral
316694353	Health concerns	1	21	9	306	28/09/09 15:11	30	safety	negative
316694353	Therapeutic use	1	3	27	4303	28/09/09 15:11	30	uses	positive
316694353	Beneficial effects	2	12	18	2012	28/09/09 15:11	30	effects	positive
316694353	Side effects	2	13	17	1623	28/09/09 15:11	30	effects	negative
316694353	Rebound / withdrawal	2	14	16	1340	28/09/09 15:11	30	safety	negative
316694353	Overdose	2	15	15	2552	28/09/09 15:11	30	effects	negative
316694353	Chronic use	2	16	14	3795	28/09/09 15:11	30	effects	negative
316694353	Harm assessment	2	25	5	1564	28/09/09 15:11	30	safety	negative
316694353	Short-term health concerns	2	22	8	1537	28/09/09 15:11	30	safety	negative
316694353	Long-term effects on serotonin and dopamine	2	23	7	6870	28/09/09 15:11	30	effects	neutral
326784737	Effects	1	11	24	901	19/11/09 19:40	35	effects	neutral
326784737	Health concerns	1	21	14	303	19/11/09 19:40	35	safety	negative
326784737	Therapeutic use	1	3	32	4368	19/11/09 19:40	35	uses	positive
326784737	Beneficial effects	2	12	23	1997	19/11/09 19:40	35	effects	positive
326784737	Side effects	2	13	22	1487	19/11/09 19:40	35	effects	negative
326784737	Overdose	2	15	20	2514	19/11/09 19:40	35	effects	negative
326784737	Chronic use	2	16	19	3794	19/11/09 19:40	35	effects	negative
326784737	Harm assessment	2	25	10	3063	19/11/09 19:40	35	safety	negative
326784737	Short-term health concerns	2	22	13	1535	19/11/09 19:40	35	safety	negative
326784737	Long-term effects on serotonin and dopamine	2	23	12	6946	19/11/09 19:40	35	effects	neutral
334937415	Effects	1	9	25	901	30/12/09 16:45	34	effects	neutral
334937415	Health concerns	1	19	15	303	30/12/09 16:45	34	safety	negative
334937415	Beneficial effects	2	10	24	1915	30/12/09 16:45	34	effects	positive
334937415	Side effects	2	11	23	1380	30/12/09 16:45	34	effects	negative
334937415	Overdose	2	13	21	2552	30/12/09 16:45	34	effects	negative
334937415	Chronic use	2	14	20	3794	30/12/09 16:45	34	effects	negative
334937415	Harm assessment	2	23	11	3099	30/12/09 16:45	34	safety	negative
334937415	Short-term health concerns	2	20	14	1535	30/12/09 16:45	34	safety	negative
334937415	Long-term effects on serotonin and dopamine	2	21	13	6946	30/12/09 16:45	34	effects	neutral
334943836	Effects	1	10	25	901	30/12/09 17:26	35	effects	neutral
334943836	Health concerns	1	20	15	303	30/12/09 17:26	35	safety	negative
334943836	Therapeutic use	1	3	32	4400	30/12/09 17:26	35	uses	positive
334943836	Beneficial effects	2	11	24	1915	30/12/09 17:26	35	effects	positive
334943836	Side effects	2	12	23	1380	30/12/09 17:26	35	effects	negative
334943836	Overdose	2	14	21	2552	30/12/09 17:26	35	effects	negative
334943836	Chronic use	2	15	20	3794	30/12/09 17:26	35	effects	negative
334943836	Harm assessment	2	24	11	3099	30/12/09 17:26	35	safety	negative
334943836	Short-term health concerns	2	21	14	1535	30/12/09 17:26	35	safety	negative
334943836	Long-term effects on serotonin and dopamine	2	22	13	6946	30/12/09 17:26	35	effects	neutral
340299286	Effects	1	10	25	901	27/01/10 08:19	35	effects	neutral
340299286	Subjective effects	2	11	24	1899	27/01/10 08:19	35	effects	neutral
340299286	Health concerns	1	20	15	303	27/01/10 08:19	35	safety	negative
340299286	Therapeutic use	1	3	32	4392	27/01/10 08:19	35	uses	positive
340299286	Side effects	2	12	23	1391	27/01/10 08:19	35	effects	negative
340299286	Overdose	2	14	21	2529	27/01/10 08:19	35	effects	negative
340299286	Chronic use	2	15	20	3794	27/01/10 08:19	35	effects	negative
340299286	Harm assessment	2	24	11	3099	27/01/10 08:19	35	safety	negative
340299286	Short-term health concerns	2	21	14	1535	27/01/10 08:19	35	safety	negative
340299286	Long-term effects on serotonin and dopamine	2	22	13	6949	27/01/10 08:19	35	effects	neutral
342591417	Effects	1	10	25	901	08/02/10 00:11	35	effects	neutral
342591417	Health concerns	1	20	15	303	08/02/10 00:11	35	safety	negative
342591417	Therapeutic use	1	3	32	4392	08/02/10 00:11	35	uses	positive
342591417	Beneficial effects	2	11	24	1827	08/02/10 00:11	35	effects	positive
342591417	Side effects	2	12	23	1741	08/02/10 00:11	35	effects	negative
342591417	Overdose	2	14	21	2530	08/02/10 00:11	35	effects	negative
342591417	Chronic use	2	15	20	3794	08/02/10 00:11	35	effects	negative
342591417	Harm assessment	2	24	11	3099	08/02/10 00:11	35	safety	negative
342591417	Short-term health concerns	2	21	14	1535	08/02/10 00:11	35	safety	negative
342591417	Long-term effects on serotonin and dopamine	2	22	13	6949	08/02/10 00:11	35	effects	neutral
344561427	Effects	1	10	25	901	17/02/10 05:36	35	effects	neutral
344561427	Subjective effects	2	11	24	1827	17/02/10 05:36	35	effects	neutral
344561427	Health concerns	1	20	15	303	17/02/10 05:36	35	safety	negative
344561427	Therapeutic use	1	3	32	4514	17/02/10 05:36	35	uses	positive
344561427	Side effects	2	12	23	1761	17/02/10 05:36	35	effects	negative
344561427	Overdose	2	14	21	2530	17/02/10 05:36	35	effects	negative
344561427	Chronic use	2	15	20	3794	17/02/10 05:36	35	effects	negative
344561427	Harm assessment	2	24	11	3099	17/02/10 05:36	35	safety	negative
344561427	Short-term health concerns	2	21	14	1535	17/02/10 05:36	35	safety	negative
344561427	Long-term effects on serotonin and dopamine	2	22	13	6934	17/02/10 05:36	35	effects	neutral
346596960	Health concerns	1	14	15	303	27/02/10 00:35	29	safety	negative
346596960	Therapeutic use	1	3	26	4514	27/02/10 00:35	29	uses	positive
346596960	Harm assessment	2	18	11	3099	27/02/10 00:35	29	safety	negative
346596960	Short-term health concerns	2	15	14	1535	27/02/10 00:35	29	safety	negative
346596960	Long-term effects on serotonin and dopamine	2	16	13	6914	27/02/10 00:35	29	effects	neutral
346597012	Effects	1	10	25	901	27/02/10 00:35	35	effects	neutral
346597012	Subjective effects	2	11	24	1827	27/02/10 00:35	35	effects	neutral
346597012	Health concerns	1	20	15	303	27/02/10 00:35	35	safety	negative
346597012	Therapeutic use	1	3	32	4514	27/02/10 00:35	35	uses	positive
346597012	Side effects	2	12	23	1370	27/02/10 00:35	35	effects	negative
346597012	Overdose	2	14	21	2530	27/02/10 00:35	35	effects	negative
346597012	Chronic use	2	15	20	3351	27/02/10 00:35	35	effects	negative
346597012	Harm assessment	2	24	11	3099	27/02/10 00:35	35	safety	negative
346597012	Short-term health concerns	2	21	14	1535	27/02/10 00:35	35	safety	negative
346597012	Long-term effects on serotonin and dopamine	2	22	13	6914	27/02/10 00:35	35	effects	neutral
389620729	Effects	1	4	24	1017	09/10/10 00:43	28	effects	neutral
389620729	Subjective effects	2	5	23	1754	09/10/10 00:43	28	effects	neutral
389620729	Health concerns	1	14	14	792	09/10/10 00:43	28	safety	negative
389620729	Side effects	2	6	22	1219	09/10/10 00:43	28	effects	negative
389620729	Overdose	2	8	20	1844	09/10/10 00:43	28	effects	negative
389620729	Chronic use	2	9	19	3473	09/10/10 00:43	28	effects	negative
389620729	Harm assessment	2	17	11	3210	09/10/10 00:43	28	safety	negative
389620729	Short-term health concerns	2	15	13	7293	09/10/10 00:43	28	safety	negative
389620780	Effects	1	10	25	1017	09/10/10 00:43	35	effects	neutral
389620780	Subjective effects	2	11	24	1754	09/10/10 00:43	35	effects	neutral
389620780	Health concerns	1	20	15	792	09/10/10 00:43	35	safety	negative
389620780	Therapeutic use	1	2	33	3704	09/10/10 00:43	35	uses	positive
389620780	Side effects	2	12	23	1219	09/10/10 00:43	35	effects	negative
389620780	Overdose	2	14	21	2055	09/10/10 00:43	35	effects	negative
389620780	Chronic use	2	15	20	3473	09/10/10 00:43	35	effects	negative
389620780	Harm assessment	2	24	11	3210	09/10/10 00:43	35	safety	negative
389620780	Short-term health concerns	2	21	14	2057	09/10/10 00:43	35	safety	negative
389620780	Long-term effects on serotonin and dopamine	2	22	13	8943	09/10/10 00:43	35	effects	neutral
416954651	Effects	1	9	25	1016	03/03/11 19:42	34	effects	neutral
416954651	Subjective effects	2	10	24	1641	03/03/11 19:42	34	effects	neutral
416954651	Health concerns	1	19	15	779	03/03/11 19:42	34	safety	negative
416954651	Side effects	2	11	23	1931	03/03/11 19:42	34	effects	negative
416954651	Overdose	2	13	21	5503	03/03/11 19:42	34	effects	negative
416954651	Chronic use	2	14	20	4008	03/03/11 19:42	34	effects	negative
416954651	Harm assessment	2	23	11	3457	03/03/11 19:42	34	safety	negative
416954651	Short-term health concerns	2	20	14	2054	03/03/11 19:42	34	safety	negative
416954651	Long-term effects on serotonin and dopamine	2	21	13	8656	03/03/11 19:42	34	effects	neutral
416954708	Effects	1	10	25	1016	03/03/11 19:42	35	effects	neutral
416954708	Subjective effects	2	11	24	1641	03/03/11 19:42	35	effects	neutral
416954708	Health concerns	1	20	15	779	03/03/11 19:42	35	safety	negative
416954708	Therapeutic use	1	2	33	5691	03/03/11 19:42	35	uses	positive
416954708	Side effects	2	12	23	1931	03/03/11 19:42	35	effects	negative
416954708	Overdose	2	14	21	5503	03/03/11 19:42	35	effects	negative
416954708	Chronic use	2	15	20	4008	03/03/11 19:42	35	effects	negative
416954708	Harm assessment	2	24	11	3457	03/03/11 19:42	35	safety	negative
416954708	Short-term health concerns	2	21	14	2054	03/03/11 19:42	35	safety	negative
416954708	Long-term effects on serotonin and dopamine	2	22	13	8656	03/03/11 19:42	35	effects	neutral
421983467	Effects	1	10	25	1016	02/04/11 14:34	35	effects	neutral
421983467	Subjective effects	2	11	24	1641	02/04/11 14:34	35	effects	neutral
421983467	Health concerns	1	20	15	779	02/04/11 14:34	35	safety	negative
421983467	Side effects	2	12	23	1931	02/04/11 14:34	35	effects	negative
421983467	Overdose	2	14	21	5540	02/04/11 14:34	35	effects	negative
421983467	Chronic use	2	15	20	4008	02/04/11 14:34	35	effects	negative
421983467	Harm assessment	2	24	11	3456	02/04/11 14:34	35	safety	negative
421983467	Short-term health concerns	2	21	14	2054	02/04/11 14:34	35	safety	negative
421983467	Long-term effects on serotonin and dopamine	2	22	13	8655	02/04/11 14:34	35	effects	neutral
421983467	Medical uses	1	2	33	5688	02/04/11 14:34	35	uses	positive
421986662	Effects	1	9	14	1016	02/04/11 15:00	23	effects	neutral
421986662	Subjective effects	2	10	13	1641	02/04/11 15:00	23	effects	neutral
421986662	Side effects	2	11	12	1931	02/04/11 15:00	23	effects	negative
421986662	Overdose	2	13	10	5540	02/04/11 15:00	23	effects	negative
421986662	Chronic use	2	14	9	4008	02/04/11 15:00	23	effects	negative
421986662	Medical uses	1	1	22	5688	02/04/11 15:00	23	uses	positive
421986782	Medical uses	1	1	16	5688	02/04/11 15:01	17	uses	positive
421986943	Effects	1	4	25	1016	02/04/11 15:02	29	effects	neutral
421986943	Subjective effects	2	5	24	1641	02/04/11 15:02	29	effects	neutral
421986943	Health concerns	2	10	19	781	02/04/11 15:02	29	safety	negative
421986943	Side effects	2	6	23	1931	02/04/11 15:02	29	effects	negative
421986943	Overdose	2	8	21	5540	02/04/11 15:02	29	effects	negative
421986943	Chronic use	2	9	20	4008	02/04/11 15:02	29	effects	negative
421986943	Harm assessment	2	14	15	3456	02/04/11 15:02	29	safety	negative
421986943	Short-term health concerns	2	11	18	2054	02/04/11 15:02	29	safety	negative
421986943	Long-term effects on serotonin and dopamine	2	12	17	8655	02/04/11 15:02	29	effects	neutral
421986943	Medical uses	1	1	28	5688	02/04/11 15:02	29	uses	positive
421987412	Effects	1	4	24	1016	02/04/11 15:06	28	effects	neutral
421987412	Subjective effects	2	5	23	1641	02/04/11 15:06	28	effects	neutral
421987412	Side effects	2	6	22	1931	02/04/11 15:06	28	effects	negative
421987412	Overdose	2	8	20	5540	02/04/11 15:06	28	effects	negative
421987412	Chronic use	2	9	19	4486	02/04/11 15:06	28	effects	negative
421987412	Harm assessment	2	13	15	3456	02/04/11 15:06	28	safety	negative
421987412	Short-term health concerns	2	10	18	2054	02/04/11 15:06	28	safety	negative
421987412	Long-term effects on serotonin and dopamine	2	11	17	8655	02/04/11 15:06	28	effects	neutral
421987412	Medical uses	1	1	27	5688	02/04/11 15:06	28	uses	positive
421988445	Subjective effects	2	4	22	2599	02/04/11 15:13	26	effects	neutral
421988445	Overdose	2	7	19	5540	02/04/11 15:13	26	effects	negative
421988445	Chronic use	2	8	18	4486	02/04/11 15:13	26	effects	negative
421988445	Harm assessment	2	12	14	3456	02/04/11 15:13	26	safety	negative
421988445	Short-term health concerns	2	9	17	2054	02/04/11 15:13	26	safety	negative
421988445	Long-term effects on serotonin and dopamine	2	10	16	8655	02/04/11 15:13	26	effects	neutral
421988445	Medical uses	1	1	25	5734	02/04/11 15:13	26	uses	positive
421988445	Adverse effects	1	5	21	1932	02/04/11 15:13	26	effects	negative
421989413	Subjective effects	2	4	22	2599	02/04/11 15:21	26	effects	neutral
421989413	Medical use	1	1	25	5733	02/04/11 15:21	26	uses	positive
421989413	Overdose	2	7	19	5540	02/04/11 15:21	26	effects	negative
421989413	Chronic use	2	8	18	4486	02/04/11 15:21	26	effects	negative
421989413	Harm assessment	2	12	14	3456	02/04/11 15:21	26	safety	negative
421989413	Short-term health concerns	2	9	17	2054	02/04/11 15:21	26	safety	negative
421989413	Long-term effects on serotonin and dopamine	2	10	16	8655	02/04/11 15:21	26	effects	neutral
421989413	Adverse effects	1	5	21	1932	02/04/11 15:21	26	effects	negative
429486585	Subjective effects	2	4	22	2462	17/05/11 01:14	26	effects	neutral
429486585	Medical use	1	1	25	5757	17/05/11 01:14	26	uses	positive
429486585	Overdose	2	7	19	5581	17/05/11 01:14	26	effects	negative
429486585	Chronic use	2	8	18	4485	17/05/11 01:14	26	effects	negative
429486585	Harm assessment	2	12	14	3457	17/05/11 01:14	26	safety	negative
429486585	Short-term health concerns	2	9	17	2054	17/05/11 01:14	26	safety	negative
429486585	Long-term effects on serotonin and dopamine	2	10	16	8656	17/05/11 01:14	26	effects	neutral
429486585	Adverse effects	1	5	21	1939	17/05/11 01:14	26	effects	negative
429486585	After-effects	2	6	20	2778	17/05/11 01:14	26	effects	neutral
429512833	Subjective effects	2	4	22	2462	17/05/11 05:44	26	effects	neutral
429512833	Overdose	2	7	19	5581	17/05/11 05:44	26	effects	negative
429512833	Chronic use	2	8	18	4485	17/05/11 05:44	26	effects	negative
429512833	Harm assessment	2	12	14	3457	17/05/11 05:44	26	safety	negative
429512833	Short-term health concerns	2	9	17	2054	17/05/11 05:44	26	safety	negative
429512833	Long-term effects on serotonin and dopamine	2	10	16	8656	17/05/11 05:44	26	effects	neutral
429512833	Medical uses	1	1	25	5759	17/05/11 05:44	26	uses	positive
429512833	Adverse effects	1	5	21	1939	17/05/11 05:44	26	effects	negative
429512833	After-effects	2	6	20	2778	17/05/11 05:44	26	effects	neutral
440506217	Subjective effects	2	4	22	2462	20/07/11 16:37	26	effects	neutral
440506217	Overdose	2	7	19	5589	20/07/11 16:37	26	effects	negative
440506217	Chronic use	2	8	18	4543	20/07/11 16:37	26	effects	negative
440506217	Harm assessment	2	12	14	3597	20/07/11 16:37	26	safety	negative
440506217	Short-term health concerns	2	9	17	2054	20/07/11 16:37	26	safety	negative
440506217	Long-term effects on serotonin and dopamine	2	10	16	8652	20/07/11 16:37	26	effects	neutral
440506217	Medical uses	1	1	25	5440	20/07/11 16:37	26	uses	positive
440506217	After-effects	2	6	20	2778	20/07/11 16:37	26	effects	neutral
440506217	Objective effects	1	5	21	1941	20/07/11 16:37	26	effects	neutral
440508181	Subjective effects	2	4	22	2462	20/07/11 16:52	26	effects	neutral
440508181	Overdose	2	7	19	5589	20/07/11 16:52	26	effects	negative
440508181	Chronic use	2	8	18	4543	20/07/11 16:52	26	effects	negative
440508181	Harm assessment	2	12	14	3597	20/07/11 16:52	26	safety	negative
440508181	Short-term health concerns	2	9	17	2054	20/07/11 16:52	26	safety	negative
440508181	Long-term effects on serotonin and dopamine	2	10	16	8652	20/07/11 16:52	26	effects	neutral
440508181	Medical uses	1	1	25	5440	20/07/11 16:52	26	uses	positive
440508181	Adverse effects	1	5	21	1939	20/07/11 16:52	26	effects	negative
440508181	After-effects	2	6	20	2778	20/07/11 16:52	26	effects	neutral
459735515	Subjective effects	2	3	22	2458	09/11/11 02:05	25	effects	neutral
459735515	Overdose	2	6	19	5569	09/11/11 02:05	25	effects	negative
459735515	Chronic use	2	7	18	4888	09/11/11 02:05	25	effects	negative
459735515	Harm assessment	2	11	14	3617	09/11/11 02:05	25	safety	negative
459735515	Short-term health concerns	2	8	17	1406	09/11/11 02:05	25	safety	negative
459735515	Long-term effects on serotonin and dopamine	2	9	16	8642	09/11/11 02:05	25	effects	neutral
459735515	Adverse effects	1	4	21	1942	09/11/11 02:05	25	effects	negative
459735515	After-effects	2	5	20	2603	09/11/11 02:05	25	effects	neutral
459735577	Overdose	2	3	19	5569	09/11/11 02:05	22	effects	negative
459735577	Chronic use	2	4	18	4888	09/11/11 02:05	22	effects	negative
459735577	Harm assessment	2	8	14	3617	09/11/11 02:05	22	safety	negative
459735577	Short-term health concerns	2	5	17	1406	09/11/11 02:05	22	safety	negative
459735577	Long-term effects on serotonin and dopamine	2	6	16	8642	09/11/11 02:05	22	effects	neutral
459735577	Adverse effects	1	1	21	1942	09/11/11 02:05	22	effects	negative
459735577	After-effects	2	2	20	2603	09/11/11 02:05	22	effects	neutral
459735710	Subjective effects	2	4	22	2458	09/11/11 02:06	26	effects	neutral
459735710	Overdose	2	7	19	5569	09/11/11 02:06	26	effects	negative
459735710	Chronic use	2	8	18	4888	09/11/11 02:06	26	effects	negative
459735710	Harm assessment	2	12	14	3617	09/11/11 02:06	26	safety	negative
459735710	Short-term health concerns	2	9	17	1406	09/11/11 02:06	26	safety	negative
459735710	Long-term effects on serotonin and dopamine	2	10	16	8642	09/11/11 02:06	26	effects	neutral
459735710	Medical uses	1	1	25	5481	09/11/11 02:06	26	uses	positive
459735710	Adverse effects	1	5	21	1942	09/11/11 02:06	26	effects	negative
459735710	After-effects	2	6	20	2603	09/11/11 02:06	26	effects	neutral
459907286	Subjective effects	2	3	22	2458	10/11/11 02:46	25	effects	neutral
459907286	Overdose	2	6	19	5569	10/11/11 02:46	25	effects	negative
459907286	Chronic use	2	7	18	4888	10/11/11 02:46	25	effects	negative
459907286	Harm assessment	2	11	14	3617	10/11/11 02:46	25	safety	negative
459907286	Short-term health concerns	2	8	17	1406	10/11/11 02:46	25	safety	negative
459907286	Long-term effects on serotonin and dopamine	2	9	16	8642	10/11/11 02:46	25	effects	neutral
459907286	Adverse effects	1	4	21	1942	10/11/11 02:46	25	effects	negative
459907286	After-effects	2	5	20	2603	10/11/11 02:46	25	effects	neutral
459907320	Subjective effects	2	4	22	2458	10/11/11 02:46	26	effects	neutral
459907320	Overdose	2	7	19	5569	10/11/11 02:46	26	effects	negative
459907320	Chronic use	2	8	18	4888	10/11/11 02:46	26	effects	negative
459907320	Harm assessment	2	12	14	3617	10/11/11 02:46	26	safety	negative
459907320	Short-term health concerns	2	9	17	1406	10/11/11 02:46	26	safety	negative
459907320	Long-term effects on serotonin and dopamine	2	10	16	8642	10/11/11 02:46	26	effects	neutral
459907320	Medical uses	1	1	25	5481	10/11/11 02:46	26	uses	positive
459907320	Adverse effects	1	5	21	1942	10/11/11 02:46	26	effects	negative
459907320	After-effects	2	6	20	2603	10/11/11 02:46	26	effects	neutral
459907541	Subjective effects	2	3	22	2458	10/11/11 02:48	25	effects	neutral
459907541	Overdose	2	6	19	5569	10/11/11 02:48	25	effects	negative
459907541	Chronic use	2	7	18	4888	10/11/11 02:48	25	effects	negative
459907541	Harm assessment	2	11	14	3617	10/11/11 02:48	25	safety	negative
459907541	Short-term health concerns	2	8	17	1406	10/11/11 02:48	25	safety	negative
459907541	Long-term effects on serotonin and dopamine	2	9	16	8642	10/11/11 02:48	25	effects	neutral
459907541	Adverse effects	1	4	21	1942	10/11/11 02:48	25	effects	negative
459907541	After-effects	2	5	20	2603	10/11/11 02:48	25	effects	neutral
459907586	Subjective effects	2	4	22	2458	10/11/11 02:48	26	effects	neutral
459907586	Overdose	2	7	19	5569	10/11/11 02:48	26	effects	negative
459907586	Chronic use	2	8	18	4888	10/11/11 02:48	26	effects	negative
459907586	Harm assessment	2	12	14	3617	10/11/11 02:48	26	safety	negative
459907586	Short-term health concerns	2	9	17	1406	10/11/11 02:48	26	safety	negative
459907586	Long-term effects on serotonin and dopamine	2	10	16	8642	10/11/11 02:48	26	effects	neutral
459907586	Medical uses	1	1	25	5481	10/11/11 02:48	26	uses	positive
459907586	Adverse effects	1	5	21	1942	10/11/11 02:48	26	effects	negative
459907586	After-effects	2	6	20	2603	10/11/11 02:48	26	effects	neutral
461609625	Subjective effects	2	4	21	2458	20/11/11 15:56	25	effects	neutral
461609625	Overdose	2	7	18	5569	20/11/11 15:56	25	effects	negative
461609625	Chronic use	2	8	17	4888	20/11/11 15:56	25	effects	negative
461609625	Harm assessment	2	11	14	3617	20/11/11 15:56	25	safety	negative
461609625	Short-term health concerns	2	9	16	1406	20/11/11 15:56	25	safety	negative
461609625	Medical uses	1	1	24	5481	20/11/11 15:56	25	uses	positive
461609625	Adverse effects	1	5	20	1942	20/11/11 15:56	25	effects	negative
461609625	After-effects	2	6	19	3211	20/11/11 15:56	25	effects	neutral
461609714	Subjective effects	2	4	22	2458	20/11/11 15:57	26	effects	neutral
461609714	Overdose	2	7	19	5569	20/11/11 15:57	26	effects	negative
461609714	Chronic use	2	8	18	4888	20/11/11 15:57	26	effects	negative
461609714	Harm assessment	2	12	14	3617	20/11/11 15:57	26	safety	negative
461609714	Short-term health concerns	2	9	17	1406	20/11/11 15:57	26	safety	negative
461609714	Long-term effects on serotonin and dopamine	2	10	16	8642	20/11/11 15:57	26	effects	neutral
461609714	Medical uses	1	1	25	5481	20/11/11 15:57	26	uses	positive
461609714	Adverse effects	1	5	21	1942	20/11/11 15:57	26	effects	negative
461609714	After-effects	2	6	20	3211	20/11/11 15:57	26	effects	neutral
480951788	Subjective effects	2	3	22	2460	09/03/12 04:52	25	effects	neutral
480951788	Overdose	2	6	19	5552	09/03/12 04:52	25	effects	negative
480951788	Chronic use	2	7	18	5168	09/03/12 04:52	25	effects	negative
480951788	Harm assessment	2	11	14	3617	09/03/12 04:52	25	safety	negative
480951788	Short-term health concerns	2	8	17	1406	09/03/12 04:52	25	safety	negative
480951788	Long-term effects on serotonin and dopamine	2	9	16	8265	09/03/12 04:52	25	effects	neutral
480951788	Adverse effects	1	4	21	2081	09/03/12 04:52	25	effects	negative
480951788	After-effects	2	5	20	3196	09/03/12 04:52	25	effects	neutral
480951816	Subjective effects	2	4	22	2460	09/03/12 04:52	26	effects	neutral
480951816	Overdose	2	7	19	5552	09/03/12 04:52	26	effects	negative
480951816	Chronic use	2	8	18	5168	09/03/12 04:52	26	effects	negative
480951816	Harm assessment	2	12	14	3617	09/03/12 04:52	26	safety	negative
480951816	Short-term health concerns	2	9	17	1406	09/03/12 04:52	26	safety	negative
480951816	Long-term effects on serotonin and dopamine	2	10	16	8265	09/03/12 04:52	26	effects	neutral
480951816	Medical uses	1	1	25	5490	09/03/12 04:52	26	uses	positive
480951816	Adverse effects	1	5	21	2081	09/03/12 04:52	26	effects	negative
480951816	After-effects	2	6	20	3196	09/03/12 04:52	26	effects	neutral
485403258	Subjective effects	2	3	22	2460	03/04/12 21:45	25	effects	neutral
485403258	Medical use	1	1	24	5524	03/04/12 21:45	25	uses	positive
485403258	Overdose	2	6	19	5552	03/04/12 21:45	25	effects	negative
485403258	Chronic use	2	7	18	5080	03/04/12 21:45	25	effects	negative
485403258	Harm assessment	2	11	14	3617	03/04/12 21:45	25	safety	negative
485403258	Short-term health concerns	2	8	17	1406	03/04/12 21:45	25	safety	negative
485403258	Long-term effects on serotonin and dopamine	2	9	16	8265	03/04/12 21:45	25	effects	neutral
485403258	Adverse effects	1	4	21	2081	03/04/12 21:45	25	effects	negative
485403258	After-effects	2	5	20	3230	03/04/12 21:45	25	effects	neutral
490649369	Subjective effects	2	3	21	2460	04/05/12 15:51	24	effects	neutral
490649369	Medical use	1	1	23	5524	04/05/12 15:51	24	uses	positive
490649369	Overdose	2	6	18	5552	04/05/12 15:51	24	effects	negative
490649369	Chronic use	2	7	17	5080	04/05/12 15:51	24	effects	negative
490649369	Harm assessment	2	10	14	3617	04/05/12 15:51	24	safety	negative
490649369	Short-term health concerns	2	8	16	9680	04/05/12 15:51	24	safety	negative
490649369	Adverse effects	1	4	20	1942	04/05/12 15:51	24	effects	negative
490649369	After-effects	2	5	19	3230	04/05/12 15:51	24	effects	neutral
490656799	Subjective effects	2	3	22	2460	04/05/12 16:44	25	effects	neutral
490656799	Medical use	1	1	24	5524	04/05/12 16:44	25	uses	positive
490656799	Overdose	2	6	19	5552	04/05/12 16:44	25	effects	negative
490656799	Chronic use	2	7	18	5080	04/05/12 16:44	25	effects	negative
490656799	Harm assessment	2	11	14	3617	04/05/12 16:44	25	safety	negative
490656799	Short-term health concerns	2	8	17	1406	04/05/12 16:44	25	safety	negative
490656799	Long-term effects on serotonin and dopamine	2	9	16	8265	04/05/12 16:44	25	effects	neutral
490656799	Adverse effects	1	4	21	1942	04/05/12 16:44	25	effects	negative
490656799	After-effects	2	5	20	3230	04/05/12 16:44	25	effects	neutral
494504576	Subjective effects	2	2	23	2240	26/05/12 19:19	25	effects	neutral
494504576	Overdose	2	5	20	5544	26/05/12 19:19	25	effects	negative
494504576	Chronic use	2	6	19	5079	26/05/12 19:19	25	effects	negative
494504576	Harm assessment	2	11	14	3619	26/05/12 19:19	25	safety	negative
494504576	Short-term health concerns	2	7	18	1406	26/05/12 19:19	25	safety	negative
494504576	Long-term effects on serotonin and dopamine	2	8	17	8265	26/05/12 19:19	25	effects	neutral
494504576	Adverse effects	1	3	22	3097	26/05/12 19:19	25	effects	negative
494504576	After-effects	2	4	21	3222	26/05/12 19:19	25	effects	neutral
494516391	Subjective effects	2	3	23	2240	26/05/12 20:54	26	effects	neutral
494516391	Medical use	1	1	25	5517	26/05/12 20:54	26	uses	positive
494516391	Overdose	2	6	20	5544	26/05/12 20:54	26	effects	negative
494516391	Chronic use	2	7	19	5079	26/05/12 20:54	26	effects	negative
494516391	Harm assessment	2	12	14	3619	26/05/12 20:54	26	safety	negative
494516391	Short-term health concerns	2	8	18	1406	26/05/12 20:54	26	safety	negative
494516391	Long-term effects on serotonin and dopamine	2	9	17	8265	26/05/12 20:54	26	effects	neutral
494516391	Adverse effects	1	4	22	3097	26/05/12 20:54	26	effects	negative
494516391	After-effects	2	5	21	3222	26/05/12 20:54	26	effects	neutral
502586353	Subjective effects	2	3	24	2240	16/07/12 08:09	27	effects	neutral
502586353	Overdose	2	6	21	5544	16/07/12 08:09	27	effects	negative
502586353	Chronic use	2	7	20	5079	16/07/12 08:09	27	effects	negative
502586353	Harm assessment	2	12	15	3619	16/07/12 08:09	27	safety	negative
502586353	Short-term health concerns	2	8	19	1406	16/07/12 08:09	27	safety	negative
502586353	Long-term effects on serotonin and dopamine	2	9	18	8265	16/07/12 08:09	27	effects	neutral
502586353	Adverse effects	1	4	23	3096	16/07/12 08:09	27	effects	negative
502586353	After-effects	2	5	22	3244	16/07/12 08:09	27	effects	neutral
502587895	Subjective effects	2	3	24	2240	16/07/12 08:27	27	effects	neutral
502587895	Medical use	1	1	26	5517	16/07/12 08:27	27	uses	positive
502587895	Overdose	2	6	21	5544	16/07/12 08:27	27	effects	negative
502587895	Chronic use	2	7	20	5079	16/07/12 08:27	27	effects	negative
502587895	Harm assessment	2	12	15	3619	16/07/12 08:27	27	safety	negative
502587895	Short-term health concerns	2	8	19	1406	16/07/12 08:27	27	safety	negative
502587895	Long-term effects on serotonin and dopamine	2	9	18	8265	16/07/12 08:27	27	effects	neutral
502587895	Adverse effects	1	4	23	3096	16/07/12 08:27	27	effects	negative
502587895	After-effects	2	5	22	3244	16/07/12 08:27	27	effects	neutral
538462303	Subjective effects	2	2	26	1649	15/02/13 20:42	28	effects	neutral
538462303	Overdose	2	5	23	6244	15/02/13 20:42	28	effects	negative
538462303	Chronic use	2	6	22	5129	15/02/13 20:42	28	effects	negative
538462303	Harm assessment	2	10	18	3598	15/02/13 20:42	28	safety	negative
538462303	Short-term health concerns	2	7	21	1515	15/02/13 20:42	28	safety	negative
538462303	Long-term effects on serotonin and dopamine	2	8	20	8270	15/02/13 20:42	28	effects	neutral
538462303	Adverse effects	1	3	25	2660	15/02/13 20:42	28	effects	negative
538462303	After-effects	2	4	24	2795	15/02/13 20:42	28	effects	neutral
538462356	Subjective effects	2	3	26	1649	15/02/13 20:42	29	effects	neutral
538462356	Medical use	1	1	28	3684	15/02/13 20:42	29	uses	positive
538462356	Overdose	2	6	23	6244	15/02/13 20:42	29	effects	negative
538462356	Chronic use	2	7	22	5129	15/02/13 20:42	29	effects	negative
538462356	Harm assessment	2	11	18	3598	15/02/13 20:42	29	safety	negative
538462356	Short-term health concerns	2	8	21	1515	15/02/13 20:42	29	safety	negative
538462356	Long-term effects on serotonin and dopamine	2	9	20	8270	15/02/13 20:42	29	effects	neutral
538462356	Adverse effects	1	4	25	2660	15/02/13 20:42	29	effects	negative
538462356	After-effects	2	5	24	2795	15/02/13 20:42	29	effects	neutral
540109709	Subjective effects	2	2	26	1649	24/02/13 18:19	28	effects	neutral
540109709	Overdose	2	5	23	6244	24/02/13 18:19	28	effects	negative
540109709	Chronic use	2	6	22	5129	24/02/13 18:19	28	effects	negative
540109709	Harm assessment	2	10	18	3598	24/02/13 18:19	28	safety	negative
540109709	Short-term health concerns	2	7	21	1433	24/02/13 18:19	28	safety	negative
540109709	Long-term effects on serotonin and dopamine	2	8	20	8270	24/02/13 18:19	28	effects	neutral
540109709	Adverse effects	1	3	25	2660	24/02/13 18:19	28	effects	negative
540109709	After-effects	2	4	24	2795	24/02/13 18:19	28	effects	neutral
540115639	Subjective effects	2	3	26	1649	24/02/13 18:55	29	effects	neutral
540115639	Medical use	1	1	28	3684	24/02/13 18:55	29	uses	positive
540115639	Overdose	2	6	23	6244	24/02/13 18:55	29	effects	negative
540115639	Chronic use	2	7	22	5129	24/02/13 18:55	29	effects	negative
540115639	Harm assessment	2	11	18	3598	24/02/13 18:55	29	safety	negative
540115639	Short-term health concerns	2	8	21	1433	24/02/13 18:55	29	safety	negative
540115639	Long-term effects on serotonin and dopamine	2	9	20	8270	24/02/13 18:55	29	effects	neutral
540115639	Adverse effects	1	4	25	2660	24/02/13 18:55	29	effects	negative
540115639	After-effects	2	5	24	2795	24/02/13 18:55	29	effects	neutral
554777995	Subjective effects	2	3	26	1641	12/05/13 20:05	29	effects	neutral
554777995	Medical use	1	1	28	3703	12/05/13 20:05	29	uses	positive
554777995	Overdose	2	6	23	6209	12/05/13 20:05	29	effects	negative
554777995	Chronic use	2	7	22	5138	12/05/13 20:05	29	effects	negative
554777995	Harm assessment	2	11	18	3547	12/05/13 20:05	29	safety	negative
554777995	Short-term health concerns	2	8	21	1412	12/05/13 20:05	29	safety	negative
554777995	Long-term effects on serotonin and dopamine	2	9	20	8248	12/05/13 20:05	29	effects	neutral
554777995	Adverse effects	1	4	25	2654	12/05/13 20:05	29	effects	negative
559678336	Subjective effects	2	2	27	1653	13/06/13 05:51	29	effects	neutral
559678336	Overdose	2	5	24	6209	13/06/13 05:51	29	effects	negative
559678336	Chronic use	2	6	23	5138	13/06/13 05:51	29	effects	negative
559678336	Harm assessment	2	10	19	3555	13/06/13 05:51	29	safety	negative
559678336	Short-term health concerns	2	7	22	1439	13/06/13 05:51	29	safety	negative
559678336	Long-term effects on serotonin and dopamine	2	8	21	8248	13/06/13 05:51	29	effects	neutral
559678336	Adverse effects	1	3	26	2654	13/06/13 05:51	29	effects	negative
559678352	Subjective effects	2	3	27	1653	13/06/13 05:52	30	effects	neutral
559678352	Medical use	1	1	29	3703	13/06/13 05:52	30	uses	positive
559678352	Overdose	2	6	24	6209	13/06/13 05:52	30	effects	negative
559678352	Chronic use	2	7	23	5138	13/06/13 05:52	30	effects	negative
559678352	Harm assessment	2	11	19	3555	13/06/13 05:52	30	safety	negative
559678352	Short-term health concerns	2	8	22	1439	13/06/13 05:52	30	safety	negative
559678352	Long-term effects on serotonin and dopamine	2	9	21	8248	13/06/13 05:52	30	effects	neutral
559678352	Adverse effects	1	4	26	2654	13/06/13 05:52	30	effects	negative
582233121	Subjective effects	2	2	27	1653	18/11/13 17:35	29	effects	neutral
582233121	Overdose	2	5	24	6145	18/11/13 17:35	29	effects	negative
582233121	Chronic use	2	6	23	4787	18/11/13 17:35	29	effects	negative
582233121	Harm assessment	2	10	19	3531	18/11/13 17:35	29	safety	negative
582233121	Short-term health concerns	2	7	22	1439	18/11/13 17:35	29	safety	negative
582233121	Long-term effects on serotonin and dopamine	2	8	21	8250	18/11/13 17:35	29	effects	neutral
582233121	Adverse effects	1	3	26	3485	18/11/13 17:35	29	effects	negative
582234183	Subjective effects	2	3	27	1653	18/11/13 17:44	30	effects	neutral
582234183	Medical use	1	1	29	3806	18/11/13 17:44	30	uses	positive
582234183	Overdose	2	6	24	6145	18/11/13 17:44	30	effects	negative
582234183	Chronic use	2	7	23	4787	18/11/13 17:44	30	effects	negative
582234183	Harm assessment	2	11	19	3531	18/11/13 17:44	30	safety	negative
582234183	Short-term health concerns	2	8	22	1439	18/11/13 17:44	30	safety	negative
582234183	Long-term effects on serotonin and dopamine	2	9	21	8250	18/11/13 17:44	30	effects	neutral
582234183	Adverse effects	1	4	26	3485	18/11/13 17:44	30	effects	negative
586546000	Subjective effects	2	3	28	1653	17/12/13 20:57	31	effects	neutral
586546000	Medical use	1	1	30	3806	17/12/13 20:57	31	uses	positive
586546000	Overdose	2	6	25	6145	17/12/13 20:57	31	effects	negative
586546000	Chronic use	2	7	24	4787	17/12/13 20:57	31	effects	negative
586546000	Harm assessment	2	11	20	3531	17/12/13 20:57	31	safety	negative
586546000	Short-term health concerns	2	8	23	1439	17/12/13 20:57	31	safety	negative
586546000	Long-term effects on serotonin and dopamine	2	9	22	8250	17/12/13 20:57	31	effects	neutral
586546000	Adverse effects	1	4	27	3485	17/12/13 20:57	31	effects	negative
586546000	Medical Use	1	26	5	735	17/12/13 20:57	31	uses	positive
586563263	Subjective effects	2	3	27	1653	17/12/13 23:13	30	effects	neutral
586563263	Medical use	1	1	29	3806	17/12/13 23:13	30	uses	positive
586563263	Overdose	2	6	24	6145	17/12/13 23:13	30	effects	negative
586563263	Chronic use	2	7	23	4787	17/12/13 23:13	30	effects	negative
586563263	Harm assessment	2	11	19	3531	17/12/13 23:13	30	safety	negative
586563263	Short-term health concerns	2	8	22	1439	17/12/13 23:13	30	safety	negative
586563263	Long-term effects on serotonin and dopamine	2	9	21	8250	17/12/13 23:13	30	effects	neutral
586563263	Adverse effects	1	4	26	3485	17/12/13 23:13	30	effects	negative
587668392	Subjective effects	2	3	28	1653	25/12/13 21:27	31	effects	neutral
587668392	Medical use	1	1	30	4933	25/12/13 21:27	31	uses	positive
587668392	Overdose	2	6	25	6145	25/12/13 21:27	31	effects	negative
587668392	Chronic use	2	7	24	4787	25/12/13 21:27	31	effects	negative
587668392	Harm assessment	2	11	20	3531	25/12/13 21:27	31	safety	negative
587668392	Short-term health concerns	2	8	23	1439	25/12/13 21:27	31	safety	negative
587668392	Long-term effects on serotonin and dopamine	2	9	22	8250	25/12/13 21:27	31	effects	neutral
587668392	Adverse effects	1	4	27	3485	25/12/13 21:27	31	effects	negative
587668392	Hormonal and in pregnancy	2	14	17	958	25/12/13 21:27	31	effects	negative
592440401	Subjective effects	2	3	28	1660	26/01/14 06:42	31	effects	neutral
592440401	Medical use	1	1	30	4928	26/01/14 06:42	31	uses	positive
592440401	Overdose	2	6	25	6497	26/01/14 06:42	31	effects	negative
592440401	Harm assessment	2	10	21	3520	26/01/14 06:42	31	safety	negative
592440401	Short-term health concerns	2	7	24	1439	26/01/14 06:42	31	safety	negative
592440401	Long-term effects on serotonin and dopamine	2	8	23	8250	26/01/14 06:42	31	effects	neutral
592440401	Adverse effects	1	4	27	3468	26/01/14 06:42	31	effects	negative
592440401	Hormonal and in pregnancy	2	13	18	981	26/01/14 06:42	31	effects	negative
592440431	Subjective effects	2	3	29	1660	26/01/14 06:42	32	effects	neutral
592440431	Medical use	1	1	31	4928	26/01/14 06:42	32	uses	positive
592440431	Overdose	2	6	26	6145	26/01/14 06:42	32	effects	negative
592440431	Chronic use	2	7	25	4787	26/01/14 06:42	32	effects	negative
592440431	Harm assessment	2	11	21	3520	26/01/14 06:42	32	safety	negative
592440431	Short-term health concerns	2	8	24	1439	26/01/14 06:42	32	safety	negative
592440431	Long-term effects on serotonin and dopamine	2	9	23	8250	26/01/14 06:42	32	effects	neutral
592440431	Adverse effects	1	4	28	3468	26/01/14 06:42	32	effects	negative
592440431	Hormonal and in pregnancy	2	14	18	981	26/01/14 06:42	32	effects	negative
598243747	Subjective effects	2	3	29	1660	05/03/14 11:42	32	effects	neutral
598243747	Medical use	1	1	31	4928	05/03/14 11:42	32	uses	positive
598243747	Overdose	2	6	26	6145	05/03/14 11:42	32	effects	negative
598243747	Chronic use	2	7	25	4828	05/03/14 11:42	32	effects	negative
598243747	Harm assessment	2	11	21	3520	05/03/14 11:42	32	safety	negative
598243747	Short-term health concerns	2	8	24	1517	05/03/14 11:42	32	safety	negative
598243747	Long-term effects on serotonin and dopamine	2	9	23	8250	05/03/14 11:42	32	effects	neutral
598243747	Adverse effects	1	4	28	4530	05/03/14 11:42	32	effects	negative
598243747	After-effects	2	5	27	2797	05/03/14 11:42	32	effects	neutral
598243747	Hormonal and in pregnancy	2	14	18	1037	05/03/14 11:42	32	effects	negative
604577739	Subjective effects	2	3	29	1777	17/04/14 10:40	32	effects	neutral
604577739	Medical use	1	1	31	5617	17/04/14 10:40	32	uses	positive
604577739	Overdose	2	7	25	6423	17/04/14 10:40	32	effects	negative
604577739	Chronic use	2	8	24	4459	17/04/14 10:40	32	effects	negative
604577739	Harm assessment	2	12	20	3520	17/04/14 10:40	32	safety	negative
604577739	Short-term health concerns	2	9	23	1533	17/04/14 10:40	32	safety	negative
604577739	Long-term effects on serotonin and dopamine	2	10	22	8250	17/04/14 10:40	32	effects	neutral
604577739	Adverse effects	1	4	28	4527	17/04/14 10:40	32	effects	negative
604577739	After-effects	2	6	26	2797	17/04/14 10:40	32	effects	neutral
604577739	Hormonal and in pregnancy	2	15	17	1037	17/04/14 10:40	32	effects	negative
604577739	Positive effects	1	5	27	77	17/04/14 10:40	32	effects	positive
604577757	Subjective effects	2	3	28	1777	17/04/14 10:40	31	effects	neutral
604577757	Medical use	1	1	30	5617	17/04/14 10:40	31	uses	positive
604577757	Overdose	2	6	25	6423	17/04/14 10:40	31	effects	negative
604577757	Chronic use	2	7	24	4459	17/04/14 10:40	31	effects	negative
604577757	Harm assessment	2	11	20	3520	17/04/14 10:40	31	safety	negative
604577757	Short-term health concerns	2	8	23	1533	17/04/14 10:40	31	safety	negative
604577757	Long-term effects on serotonin and dopamine	2	9	22	8250	17/04/14 10:40	31	effects	neutral
604577757	Adverse effects	1	4	27	4527	17/04/14 10:40	31	effects	negative
604577757	After-effects	2	5	26	2797	17/04/14 10:40	31	effects	neutral
604577757	Hormonal and in pregnancy	2	14	17	1037	17/04/14 10:40	31	effects	negative
622297413	Subjective effects	2	4	29	1822	22/08/14 05:49	33	effects	neutral
622297413	Medical use	1	1	32	353	22/08/14 05:49	33	uses	positive
622297413	Overdose	2	7	26	6872	22/08/14 05:49	33	effects	negative
622297413	Harm assessment	2	12	21	3552	22/08/14 05:49	33	safety	negative
622297413	Short-term health concerns	2	9	24	1660	22/08/14 05:49	33	safety	negative
622297413	Long-term effects on serotonin and dopamine	2	10	23	9041	22/08/14 05:49	33	effects	neutral
622297413	Adverse effects	1	5	28	5295	22/08/14 05:49	33	effects	negative
622297413	After-effects	2	6	27	2797	22/08/14 05:49	33	effects	neutral
622297413	Hormonal and in pregnancy	2	14	19	1026	22/08/14 05:49	33	effects	negative
622297413	Chronic use and addiction	2	8	25	3253	22/08/14 05:49	33	effects	negative
629714590	Subjective effects	3	5	29	1831	15/10/14 14:16	34	effects	neutral
629714590	Overdose	1	9	25	6646	15/10/14 14:16	34	effects	negative
629714590	Harm assessment	2	14	20	3911	15/10/14 14:16	34	safety	negative
629714590	Short-term health concerns	2	11	23	1660	15/10/14 14:16	34	safety	negative
629714590	Long-term effects on serotonin and dopamine	2	12	22	9081	15/10/14 14:16	34	effects	neutral
629714590	Adverse effects	1	6	28	5756	15/10/14 14:16	34	effects	negative
629714590	After-effects	2	7	27	2093	15/10/14 14:16	34	effects	neutral
629714590	Hormonal and in pregnancy	2	8	26	1026	15/10/14 14:16	34	effects	negative
629714590	Chronic use and addiction	2	10	24	3326	15/10/14 14:16	34	effects	negative
629714590	Medical	2	2	32	351	15/10/14 14:16	34	uses	positive
629824444	Subjective effects	3	5	23	1831	16/10/14 07:56	28	effects	neutral
629824444	Overdose	1	9	19	6646	16/10/14 07:56	28	effects	negative
629824444	Harm assessment	2	13	15	3911	16/10/14 07:56	28	safety	negative
629824444	Short-term health concerns	2	11	17	1660	16/10/14 07:56	28	safety	negative
629824444	Adverse effects	1	6	22	5792	16/10/14 07:56	28	effects	negative
629824444	After-effects	2	7	21	2093	16/10/14 07:56	28	effects	neutral
629824444	Hormonal and in pregnancy	2	8	20	1025	16/10/14 07:56	28	effects	negative
629824444	Chronic use and addiction	2	10	18	3326	16/10/14 07:56	28	effects	negative
629824444	Medical	2	2	26	351	16/10/14 07:56	28	uses	positive
629845391	Subjective effects	2	4	29	1829	16/10/14 12:48	33	effects	neutral
629845391	Medical use	1	1	32	353	16/10/14 12:48	33	uses	positive
629845391	Overdose	2	7	26	6595	16/10/14 12:48	33	effects	negative
629845391	Harm assessment	2	12	21	3911	16/10/14 12:48	33	safety	negative
629845391	Short-term health concerns	2	9	24	1660	16/10/14 12:48	33	safety	negative
629845391	Long-term effects on serotonin and dopamine	2	10	23	9081	16/10/14 12:48	33	effects	neutral
629845391	Adverse effects	1	5	28	5169	16/10/14 12:48	33	effects	negative
629845391	After-effects	2	6	27	2093	16/10/14 12:48	33	effects	neutral
629845391	Hormonal and in pregnancy	2	14	19	1026	16/10/14 12:48	33	effects	negative
629845391	Chronic use and addiction	2	8	25	3297	16/10/14 12:48	33	effects	negative
629847994	Subjective effects	3	5	23	1831	16/10/14 13:18	28	effects	neutral
629847994	Overdose	1	9	19	6646	16/10/14 13:18	28	effects	negative
629847994	Harm assessment	2	13	15	3911	16/10/14 13:18	28	safety	negative
629847994	Short-term health concerns	2	11	17	1660	16/10/14 13:18	28	safety	negative
629847994	Adverse effects	1	6	22	5792	16/10/14 13:18	28	effects	negative
629847994	After-effects	2	7	21	2093	16/10/14 13:18	28	effects	neutral
629847994	Hormonal and in pregnancy	2	8	20	1025	16/10/14 13:18	28	effects	negative
629847994	Chronic use and addiction	2	10	18	3326	16/10/14 13:18	28	effects	negative
629847994	Medical	2	2	26	351	16/10/14 13:18	28	uses	positive
629859725	Subjective effects	3	5	22	1831	16/10/14 15:09	27	effects	neutral
629859725	Overdose	1	9	18	6646	16/10/14 15:09	27	effects	negative
629859725	Harm assessment	2	12	15	3911	16/10/14 15:09	27	safety	negative
629859725	Adverse effects	1	6	21	7936	16/10/14 15:09	27	effects	negative
629859725	After-effects	2	8	19	2990	16/10/14 15:09	27	effects	neutral
629859725	Chronic use and addiction	2	10	17	3910	16/10/14 15:09	27	effects	negative
629859725	Medical	2	2	25	351	16/10/14 15:09	27	uses	positive
629859725	Immediate effects	2	7	20	36	16/10/14 15:09	27	effects	neutral
630020170	Overdose	1	10	17	5544	17/10/14 19:42	27	effects	negative
630020170	Harm assessment	2	19	8	1832	17/10/14 19:42	27	safety	negative
630020170	Adverse effects	1	7	20	3533	17/10/14 19:42	27	effects	negative
630020170	After-effects	2	9	18	1485	17/10/14 19:42	27	effects	neutral
630020170	Chronic use and addiction	2	11	16	3910	17/10/14 19:42	27	effects	negative
630020170	Medical	2	2	25	372	17/10/14 19:42	27	uses	positive
630020170	Immediate effects	2	8	19	3382	17/10/14 19:42	27	effects	neutral
630020170	Recreational effects	3	6	21	1138	17/10/14 19:42	27	effects	positive
635414408	Overdose	1	7	16	4383	25/11/14 19:15	23	effects	negative
635414408	Harm assessment	2	16	7	1830	25/11/14 19:15	23	safety	negative
635414408	Adverse effects	1	4	19	5492	25/11/14 19:15	23	effects	negative
635414408	After-effects	2	6	17	1584	25/11/14 19:15	23	effects	neutral
635414408	Chronic use and addiction	2	8	15	4320	25/11/14 19:15	23	effects	negative
635414408	Immediate effects	2	5	18	3325	25/11/14 19:15	23	effects	neutral
635414408	Recreational effects	2	2	21	1544	25/11/14 19:15	23	effects	positive
635414760	Overdose	1	10	16	4383	25/11/14 19:18	26	effects	negative
635414760	Harm assessment	2	19	7	1830	25/11/14 19:18	26	safety	negative
635414760	Adverse effects	1	7	19	5492	25/11/14 19:18	26	effects	negative
635414760	After-effects	2	9	17	1584	25/11/14 19:18	26	effects	neutral
635414760	Chronic use and addiction	2	11	15	4320	25/11/14 19:18	26	effects	negative
635414760	Medical	2	2	24	372	25/11/14 19:18	26	uses	positive
635414760	Immediate effects	2	8	18	3325	25/11/14 19:18	26	effects	neutral
635414760	Recreational effects	3	5	21	1544	25/11/14 19:18	26	effects	positive
640304798	Overdose	1	11	16	4383	30/12/14 23:20	27	effects	negative
640304798	Harm assessment	2	20	7	1830	30/12/14 23:20	27	safety	negative
640304798	Adverse effects	1	8	19	5492	30/12/14 23:20	27	effects	negative
640304798	After-effects	2	10	17	1584	30/12/14 23:20	27	effects	neutral
640304798	Chronic use and addiction	2	12	15	4308	30/12/14 23:20	27	effects	negative
640304798	Medical	2	2	25	372	30/12/14 23:20	27	uses	positive
640304798	Immediate effects	2	9	18	3241	30/12/14 23:20	27	effects	neutral
640304798	Recreational effects	3	6	21	1544	30/12/14 23:20	27	effects	positive
640304798	Underground therapy	3	4	23	388	30/12/14 23:20	27	uses	positive
640927452	Therapeutic use	2	22	11	3330	04/01/15 10:22	33	uses	positive
640927452	Overdose	1	10	23	4383	04/01/15 10:22	33	effects	negative
640927452	Harm assessment	2	26	7	578	04/01/15 10:22	33	safety	negative
640927452	Adverse effects	1	7	26	5954	04/01/15 10:22	33	effects	negative
640927452	After-effects	2	9	24	1584	04/01/15 10:22	33	effects	neutral
640927452	Chronic use and addiction	1	11	22	4306	04/01/15 10:22	33	effects	negative
640927452	Medical	2	2	31	372	04/01/15 10:22	33	uses	positive
640927452	Immediate effects	2	8	25	3241	04/01/15 10:22	33	effects	neutral
640927452	Recreational effects	3	5	28	1544	04/01/15 10:22	33	effects	positive
640927452	Underground therapy	2	25	8	409	04/01/15 10:22	33	uses	positive
640980316	Overdose	1	10	23	4383	04/01/15 19:29	33	effects	negative
640980316	Harm assessment	2	26	7	578	04/01/15 19:29	33	safety	negative
640980316	Adverse effects	1	7	26	5954	04/01/15 19:29	33	effects	negative
640980316	After-effects	2	9	24	1584	04/01/15 19:29	33	effects	neutral
640980316	Chronic use and addiction	1	11	22	4306	04/01/15 19:29	33	effects	negative
640980316	Medical	2	2	31	372	04/01/15 19:29	33	uses	positive
640980316	Immediate effects	2	8	25	3240	04/01/15 19:29	33	effects	neutral
640980316	Recreational effects	3	5	28	1544	04/01/15 19:29	33	effects	positive
640980316	Underground therapy	2	25	8	409	04/01/15 19:29	33	uses	positive
640980399	Therapeutic use	2	22	11	3330	04/01/15 19:30	33	uses	positive
640980399	Overdose	1	10	23	4383	04/01/15 19:30	33	effects	negative
640980399	Harm assessment	2	26	7	578	04/01/15 19:30	33	safety	negative
640980399	Adverse effects	1	7	26	5954	04/01/15 19:30	33	effects	negative
640980399	After-effects	2	9	24	1584	04/01/15 19:30	33	effects	neutral
640980399	Chronic use and addiction	1	11	22	4306	04/01/15 19:30	33	effects	negative
640980399	Medical	2	2	31	372	04/01/15 19:30	33	uses	positive
640980399	Immediate effects	2	8	25	3240	04/01/15 19:30	33	effects	neutral
640980399	Recreational effects	3	5	28	1544	04/01/15 19:30	33	effects	positive
640980399	Underground therapy	2	25	8	409	04/01/15 19:30	33	uses	positive
640980658	Overdose	1	10	23	4383	04/01/15 19:32	33	effects	negative
640980658	Harm assessment	2	26	7	578	04/01/15 19:32	33	safety	negative
640980658	Adverse effects	1	7	26	5954	04/01/15 19:32	33	effects	negative
640980658	After-effects	2	9	24	1584	04/01/15 19:32	33	effects	neutral
640980658	Chronic use and addiction	1	11	22	4306	04/01/15 19:32	33	effects	negative
640980658	Medical	2	2	31	372	04/01/15 19:32	33	uses	positive
640980658	Immediate effects	2	8	25	3240	04/01/15 19:32	33	effects	neutral
640980658	Recreational effects	3	5	28	1544	04/01/15 19:32	33	effects	positive
640980658	Underground therapy	2	25	8	409	04/01/15 19:32	33	uses	positive
643319391	Effects	1	1	33	1532	20/01/15 04:46	34	effects	neutral
643319391	Overdose	1	10	24	4383	20/01/15 04:46	34	effects	negative
643319391	Harm assessment	2	28	6	578	20/01/15 04:46	34	safety	negative
643319391	Adverse effects	1	7	27	5990	20/01/15 04:46	34	effects	negative
643319391	After-effects	2	9	25	1584	20/01/15 04:46	34	effects	neutral
643319391	Chronic use and addiction	1	11	23	4306	20/01/15 04:46	34	effects	negative
643319391	Medical	2	3	31	372	20/01/15 04:46	34	uses	positive
643319391	Immediate effects	2	8	26	3240	20/01/15 04:46	34	effects	neutral
643319391	Underground therapy	2	27	7	409	20/01/15 04:46	34	uses	positive
645013543	Effects	1	1	32	1532	31/01/15 17:16	33	effects	neutral
645013543	Overdose	1	10	23	4383	31/01/15 17:16	33	effects	negative
645013543	Harm assessment	2	27	6	578	31/01/15 17:16	33	safety	negative
645013543	Adverse effects	1	7	26	5990	31/01/15 17:16	33	effects	negative
645013543	After-effects	2	9	24	1584	31/01/15 17:16	33	effects	neutral
645013543	Chronic use and addiction	1	11	22	4306	31/01/15 17:16	33	effects	negative
645013543	Medical	2	3	30	372	31/01/15 17:16	33	uses	positive
645013543	Immediate effects	2	8	25	3240	31/01/15 17:16	33	effects	neutral
647279514	Overdose	1	10	24	4391	15/02/15 19:10	34	effects	negative
647279514	Harm assessment	3	32	2	1313	15/02/15 19:10	34	safety	negative
647279514	Adverse effects	1	7	27	5536	15/02/15 19:10	34	effects	negative
647279514	After-effects	2	9	25	1584	15/02/15 19:10	34	effects	neutral
647279514	Chronic use and addiction	1	11	23	4309	15/02/15 19:10	34	effects	negative
647279514	Medical	2	2	32	118	15/02/15 19:10	34	uses	positive
647279514	Immediate effects	2	8	26	3651	15/02/15 19:10	34	effects	neutral
647279514	Recreational effects	3	5	29	1550	15/02/15 19:10	34	effects	positive
647291607	Effects	1	1	33	1533	15/02/15 20:47	34	effects	neutral
647291607	Overdose	1	10	24	4391	15/02/15 20:47	34	effects	negative
647291607	Harm assessment	3	32	2	1313	15/02/15 20:47	34	safety	negative
647291607	Adverse effects	1	7	27	5535	15/02/15 20:47	34	effects	negative
647291607	After-effects	2	9	25	1584	15/02/15 20:47	34	effects	neutral
647291607	Chronic use and addiction	1	11	23	4309	15/02/15 20:47	34	effects	negative
647291607	Medical	2	3	31	118	15/02/15 20:47	34	uses	positive
647291607	Immediate effects	2	8	26	3651	15/02/15 20:47	34	effects	neutral
647292437	Overdose	1	10	24	4391	15/02/15 20:54	34	effects	negative
647292437	Harm assessment	3	32	2	1313	15/02/15 20:54	34	safety	negative
647292437	Adverse effects	1	7	27	5535	15/02/15 20:54	34	effects	negative
647292437	After-effects	2	9	25	1584	15/02/15 20:54	34	effects	neutral
647292437	Chronic use and addiction	1	11	23	4309	15/02/15 20:54	34	effects	negative
647292437	Medical	2	2	32	118	15/02/15 20:54	34	uses	positive
647292437	Immediate effects	2	8	26	3651	15/02/15 20:54	34	effects	neutral
647292437	Recreational effects	3	5	29	1550	15/02/15 20:54	34	effects	positive
648384506	Overdose	1	10	25	4811	22/02/15 22:09	35	effects	negative
648384506	Harm assessment	3	32	3	1313	22/02/15 22:09	35	safety	negative
648384506	Adverse effects	1	6	29	5535	22/02/15 22:09	35	effects	negative
648384506	After-effects	2	8	27	1584	22/02/15 22:09	35	effects	neutral
648384506	Chronic use and addiction	2	11	24	2087	22/02/15 22:09	35	effects	negative
648384506	Medical	2	2	33	118	22/02/15 22:09	35	uses	positive
648384506	Immediate effects	2	7	28	3651	22/02/15 22:09	35	effects	neutral
648384506	Recreational effects	3	4	31	1550	22/02/15 22:09	35	effects	positive
648384506	Dependence and withdrawal	2	9	26	2235	22/02/15 22:09	35	safety	negative
648413040	Long-term effects	2	9	27	4244	23/02/15 01:59	36	effects	neutral
648413040	Overdose	1	11	25	4815	23/02/15 01:59	36	effects	negative
648413040	Harm assessment	3	33	3	1313	23/02/15 01:59	36	safety	negative
648413040	Adverse effects	1	6	30	21	23/02/15 01:59	36	effects	negative
648413040	After-effects	2	8	28	1584	23/02/15 01:59	36	effects	neutral
648413040	Chronic use and addiction	2	12	24	2087	23/02/15 01:59	36	effects	negative
648413040	Medical	2	2	34	118	23/02/15 01:59	36	uses	positive
648413040	Immediate effects	2	7	29	4965	23/02/15 01:59	36	effects	neutral
648413040	Recreational effects	3	4	32	1550	23/02/15 01:59	36	effects	positive
648413040	Dependence and withdrawal	2	10	26	2235	23/02/15 01:59	36	safety	negative
678136471	Long-term effects	2	9	30	4241	27/08/15 16:05	39	effects	neutral
678136471	Overdose	2	12	27	4908	27/08/15 16:05	39	effects	negative
678136471	Adverse effects	1	6	33	21	27/08/15 16:05	39	effects	negative
678136471	After-effects	2	8	31	1551	27/08/15 16:05	39	effects	neutral
678136471	Chronic use and addiction	2	11	28	2096	27/08/15 16:05	39	effects	negative
678136471	Medical	2	2	37	144	27/08/15 16:05	39	uses	positive
678136471	Immediate effects	2	7	32	6159	27/08/15 16:05	39	effects	neutral
678136471	Recreational effects	3	4	35	1553	27/08/15 16:05	39	effects	positive
678136471	Dependence and withdrawal	2	10	29	2231	27/08/15 16:05	39	safety	negative
678151208	Long-term effects	2	9	29	5855	27/08/15 17:47	38	effects	neutral
678151208	Overdose	2	11	27	4908	27/08/15 17:47	38	effects	negative
678151208	Adverse effects	1	6	32	21	27/08/15 17:47	38	effects	negative
678151208	After-effects	2	8	30	1551	27/08/15 17:47	38	effects	neutral
678151208	Medical	2	2	36	469	27/08/15 17:47	38	uses	positive
678151208	Immediate effects	2	7	31	6544	27/08/15 17:47	38	effects	neutral
678151208	Recreational effects	3	4	34	1553	27/08/15 17:47	38	effects	positive
678151208	Reinforcement disorders	2	10	28	2659	27/08/15 17:47	38	effects	neutral
684783721	Long-term effects	2	9	28	7011	08/10/15 18:42	37	effects	neutral
684783721	Overdose	2	11	26	5006	08/10/15 18:42	37	effects	negative
684783721	Harm assessment	2	34	3	2260	08/10/15 18:42	37	safety	negative
684783721	Adverse effects	1	6	31	21	08/10/15 18:42	37	effects	negative
684783721	After-effects	2	8	29	1551	08/10/15 18:42	37	effects	neutral
684783721	Medical	2	2	35	469	08/10/15 18:42	37	uses	positive
684783721	Immediate effects	2	7	30	6664	08/10/15 18:42	37	effects	neutral
684783721	Recreational effects	3	4	33	1618	08/10/15 18:42	37	effects	positive
684783721	Reinforcement disorders	2	10	27	2659	08/10/15 18:42	37	effects	neutral
699745427	Effects	2	5	39	1603	14/01/16 05:32	44	effects	neutral
699745427	Long-term effects	2	11	33	7014	14/01/16 05:32	44	effects	neutral
699745427	Overdose	2	13	31	5026	14/01/16 05:32	44	effects	negative
699745427	Harm assessment	2	41	3	2548	14/01/16 05:32	44	safety	negative
699745427	Adverse effects	1	8	36	21	14/01/16 05:32	44	effects	negative
699745427	After-effects	2	10	34	1561	14/01/16 05:32	44	effects	neutral
699745427	Medical	2	2	42	459	14/01/16 05:32	44	uses	positive
699745427	Immediate effects	2	9	35	5115	14/01/16 05:32	44	effects	neutral
699745427	Reinforcement disorders	2	12	32	2659	14/01/16 05:32	44	effects	neutral
699745427	Spiritual	2	4	40	125	14/01/16 05:32	44	uses	positive
704224403	Effects	2	6	39	1603	10/02/16 08:57	45	effects	neutral
704224403	Long-term effects	2	12	33	7174	10/02/16 08:57	45	effects	neutral
704224403	Overdose	2	14	31	5026	10/02/16 08:57	45	effects	negative
704224403	Harm assessment	2	42	3	2551	10/02/16 08:57	45	safety	negative
704224403	Adverse effects	1	9	36	21	10/02/16 08:57	45	effects	negative
704224403	After-effects	2	11	34	1561	10/02/16 08:57	45	effects	neutral
704224403	Medical	2	2	43	383	10/02/16 08:57	45	uses	positive
704224403	Immediate effects	2	10	35	5115	10/02/16 08:57	45	effects	neutral
704224403	Reinforcement disorders	2	13	32	2659	10/02/16 08:57	45	effects	neutral
704224403	Spiritual	2	5	40	419	10/02/16 08:57	45	uses	positive
704224403	Alternative medicine	2	3	42	160	10/02/16 08:57	45	uses	positive
704226250	Effects	2	6	39	1537	10/02/16 09:14	45	effects	neutral
704226250	Overdose	2	14	31	5026	10/02/16 09:14	45	effects	negative
704226250	Harm assessment	2	42	3	2551	10/02/16 09:14	45	safety	negative
704226250	Adverse effects	1	9	36	21	10/02/16 09:14	45	effects	negative
704226250	Medical	2	2	43	383	10/02/16 09:14	45	uses	positive
704226250	Reinforcement disorders	2	13	32	2659	10/02/16 09:14	45	effects	neutral
704226250	Spiritual	2	5	40	419	10/02/16 09:14	45	uses	positive
704226250	Alternative medicine	2	3	42	187	10/02/16 09:14	45	uses	positive
704226250	Short-term	2	10	35	5108	10/02/16 09:14	45	effects	neutral
704226250	Intermediate-term	2	11	34	1573	10/02/16 09:14	45	effects	neutral
704226250	Long-term	2	12	33	7166	10/02/16 09:14	45	effects	neutral
705237590	Overdose	2	14	31	5026	16/02/16 08:56	45	effects	negative
705237590	Harm assessment	2	42	3	2551	16/02/16 08:56	45	safety	negative
705237590	Adverse effects	1	9	36	21	16/02/16 08:56	45	effects	negative
705237590	Medical	2	2	43	383	16/02/16 08:56	45	uses	positive
705237590	Reinforcement disorders	2	13	32	2659	16/02/16 08:56	45	effects	neutral
705237590	Spiritual	2	5	40	419	16/02/16 08:56	45	uses	positive
705237590	Alternative medicine	2	3	42	187	16/02/16 08:56	45	uses	positive
705237590	Short-term	2	10	35	5035	16/02/16 08:56	45	effects	neutral
705237590	Intermediate-term	2	11	34	1573	16/02/16 08:56	45	effects	neutral
705237590	Long-term	2	12	33	7166	16/02/16 08:56	45	effects	neutral
705237746	Effects	1	8	37	1535	16/02/16 08:58	45	effects	neutral
705237746	Overdose	2	14	31	5026	16/02/16 08:58	45	effects	negative
705237746	Harm assessment	2	42	3	2551	16/02/16 08:58	45	safety	negative
705237746	Adverse effects	1	9	36	21	16/02/16 08:58	45	effects	negative
705237746	Medical	2	2	43	383	16/02/16 08:58	45	uses	positive
705237746	Reinforcement disorders	2	13	32	2659	16/02/16 08:58	45	effects	neutral
705237746	Spiritual	2	5	40	419	16/02/16 08:58	45	uses	positive
705237746	Alternative medicine	2	3	42	187	16/02/16 08:58	45	uses	positive
705237746	Short-term	2	10	35	5035	16/02/16 08:58	45	effects	neutral
705237746	Intermediate-term	2	11	34	1573	16/02/16 08:58	45	effects	neutral
705237746	Long-term	2	12	33	7166	16/02/16 08:58	45	effects	neutral
705296894	Effects	1	8	38	1535	16/02/16 17:55	46	effects	neutral
705296894	Overdose	2	15	31	5026	16/02/16 17:55	46	effects	negative
705296894	Harm assessment	2	43	3	2551	16/02/16 17:55	46	safety	negative
705296894	Adverse effects	1	9	37	21	16/02/16 17:55	46	effects	negative
705296894	Medical	2	2	44	383	16/02/16 17:55	46	uses	positive
705296894	Reinforcement disorders	2	14	32	2659	16/02/16 17:55	46	effects	neutral
705296894	Spiritual	2	5	41	419	16/02/16 17:55	46	uses	positive
705296894	Alternative medicine	2	3	43	187	16/02/16 17:55	46	uses	positive
705296894	Short-term	2	10	36	5035	16/02/16 17:55	46	effects	neutral
705296894	Intermediate-term	2	11	35	1573	16/02/16 17:55	46	effects	neutral
705296894	Long-term	2	12	34	6531	16/02/16 17:55	46	effects	neutral
705296894	In pregnancy	2	13	33	656	16/02/16 17:55	46	effects	negative
706678470	Effects	1	7	38	1535	24/02/16 17:51	45	effects	neutral
706678470	Overdose	2	14	31	5026	24/02/16 17:51	45	effects	negative
706678470	Harm assessment	2	42	3	2551	24/02/16 17:51	45	safety	negative
706678470	Adverse effects	1	8	37	21	24/02/16 17:51	45	effects	negative
706678470	Medical	2	2	43	501	24/02/16 17:51	45	uses	positive
706678470	Reinforcement disorders	2	13	32	2659	24/02/16 17:51	45	effects	neutral
706678470	Alternative medicine	2	3	42	187	24/02/16 17:51	45	uses	positive
706678470	Short-term	2	9	36	5035	24/02/16 17:51	45	effects	neutral
706678470	Intermediate-term	2	10	35	1573	24/02/16 17:51	45	effects	neutral
706678470	Long-term	2	11	34	6508	24/02/16 17:51	45	effects	neutral
706678470	In pregnancy	2	12	33	656	24/02/16 17:51	45	effects	negative
706678470	Recreational and spiritual	2	4	41	2005	24/02/16 17:51	45	uses	neutral
710674837	Effects	1	7	38	1468	18/03/16 10:28	45	effects	neutral
710674837	Overdose	2	14	31	4990	18/03/16 10:28	45	effects	negative
710674837	Harm assessment	2	42	3	2551	18/03/16 10:28	45	safety	negative
710674837	Adverse effects	1	8	37	21	18/03/16 10:28	45	effects	negative
710674837	Medical	2	2	43	501	18/03/16 10:28	45	uses	positive
710674837	Reinforcement disorders	2	13	32	2659	18/03/16 10:28	45	effects	neutral
710674837	Short-term	2	9	36	5035	18/03/16 10:28	45	effects	neutral
710674837	Intermediate-term	2	10	35	1573	18/03/16 10:28	45	effects	neutral
710674837	Long-term	2	11	34	6512	18/03/16 10:28	45	effects	neutral
710674837	In pregnancy	2	12	33	1551	18/03/16 10:28	45	effects	negative
710674837	Recreational and spiritual	2	4	41	2005	18/03/16 10:28	45	uses	neutral
710674837	Unlicensed medical use	2	3	42	189	18/03/16 10:28	45	uses	neutral
710714497	Effects	1	7	38	1468	18/03/16 16:42	45	effects	neutral
710714497	Overdose	2	14	31	4990	18/03/16 16:42	45	effects	negative
710714497	Harm assessment	2	42	3	2551	18/03/16 16:42	45	safety	negative
710714497	Adverse effects	1	8	37	21	18/03/16 16:42	45	effects	negative
710714497	Medical	2	2	43	501	18/03/16 16:42	45	uses	positive
710714497	Reinforcement disorders	2	13	32	2659	18/03/16 16:42	45	effects	neutral
710714497	Alternative medicine	2	3	42	187	18/03/16 16:42	45	uses	positive
710714497	Short-term	2	9	36	5035	18/03/16 16:42	45	effects	neutral
710714497	Intermediate-term	2	10	35	1573	18/03/16 16:42	45	effects	neutral
710714497	Long-term	2	11	34	6512	18/03/16 16:42	45	effects	neutral
710714497	In pregnancy	2	12	33	1551	18/03/16 16:42	45	effects	negative
710714497	Recreational and spiritual	2	4	41	2005	18/03/16 16:42	45	uses	neutral
712897123	Effects	1	7	40	1163	31/03/16 18:43	47	effects	neutral
712897123	Overdose	2	14	33	4990	31/03/16 18:43	47	effects	negative
712897123	Harm assessment	2	42	5	2551	31/03/16 18:43	47	safety	negative
712897123	Adverse effects	1	8	39	21	31/03/16 18:43	47	effects	negative
712897123	Medical	2	2	45	501	31/03/16 18:43	47	uses	positive
712897123	Reinforcement disorders	2	13	34	2384	31/03/16 18:43	47	effects	neutral
712897123	Alternative medicine	2	3	44	187	31/03/16 18:43	47	uses	positive
712897123	Short-term	2	9	38	3041	31/03/16 18:43	47	effects	neutral
712897123	Intermediate-term	2	10	37	1529	31/03/16 18:43	47	effects	neutral
712897123	Long-term	2	11	36	6204	31/03/16 18:43	47	effects	neutral
712897123	Recreational and spiritual	2	4	43	2005	31/03/16 18:43	47	uses	neutral
712897123	Pregnancy	2	12	35	1524	31/03/16 18:43	47	effects	negative
714613951	Effects	1	6	39	1185	10/04/16 20:47	45	effects	neutral
714613951	Overdose	2	13	32	4990	10/04/16 20:47	45	effects	negative
714613951	Harm assessment	2	41	4	2556	10/04/16 20:47	45	safety	negative
714613951	Adverse effects	1	7	38	21	10/04/16 20:47	45	effects	negative
714613951	Medical	2	2	43	501	10/04/16 20:47	45	uses	positive
714613951	Reinforcement disorders	2	12	33	2377	10/04/16 20:47	45	effects	neutral
714613951	Short-term	2	8	37	3041	10/04/16 20:47	45	effects	neutral
714613951	Intermediate-term	2	9	36	1529	10/04/16 20:47	45	effects	neutral
714613951	Long-term	2	10	35	6203	10/04/16 20:47	45	effects	neutral
714613951	Recreational and spiritual	2	3	42	2005	10/04/16 20:47	45	uses	neutral
714613951	Pregnancy	2	11	34	1467	10/04/16 20:47	45	effects	negative
714614082	Effects	1	6	39	1185	10/04/16 20:48	45	effects	neutral
714614082	Overdose	2	13	32	4990	10/04/16 20:48	45	effects	negative
714614082	Harm assessment	2	41	4	2556	10/04/16 20:48	45	safety	negative
714614082	Adverse effects	1	7	38	21	10/04/16 20:48	45	effects	negative
714614082	Medical	2	2	43	501	10/04/16 20:48	45	uses	positive
714614082	Reinforcement disorders	2	12	33	2377	10/04/16 20:48	45	effects	neutral
714614082	Short-term	2	8	37	3041	10/04/16 20:48	45	effects	neutral
714614082	Intermediate-term	2	9	36	1529	10/04/16 20:48	45	effects	neutral
714614082	Long-term	2	10	35	6203	10/04/16 20:48	45	effects	neutral
714614082	Pregnancy	2	11	34	1467	10/04/16 20:48	45	effects	negative
716315792	Effects	1	7	39	1185	21/04/16 02:35	46	effects	neutral
716315792	Overdose	2	14	32	4990	21/04/16 02:35	46	effects	negative
716315792	Harm assessment	2	42	4	2559	21/04/16 02:35	46	safety	negative
716315792	Adverse effects	1	8	38	21	21/04/16 02:35	46	effects	negative
716315792	Medical	2	2	44	501	21/04/16 02:35	46	uses	positive
716315792	Reinforcement disorders	2	13	33	2377	21/04/16 02:35	46	effects	neutral
716315792	Alternative medicine	2	3	43	583	21/04/16 02:35	46	uses	positive
716315792	Short-term	2	9	37	2858	21/04/16 02:35	46	effects	neutral
716315792	Intermediate-term	2	10	36	1529	21/04/16 02:35	46	effects	neutral
716315792	Long-term	2	11	35	6203	21/04/16 02:35	46	effects	neutral
716315792	Pregnancy	2	12	34	1433	21/04/16 02:35	46	effects	negative
718704054	Effects	1	7	39	1227	05/05/16 03:20	46	effects	neutral
718704054	Overdose	2	14	32	4990	05/05/16 03:20	46	effects	negative
718704054	Harm assessment	2	42	4	2559	05/05/16 03:20	46	safety	negative
718704054	Adverse effects	1	8	38	21	05/05/16 03:20	46	effects	negative
718704054	Medical	2	2	44	816	05/05/16 03:20	46	uses	positive
718704054	Reinforcement disorders	2	13	33	2377	05/05/16 03:20	46	effects	neutral
718704054	Alternative medicine	2	3	43	532	05/05/16 03:20	46	uses	positive
718704054	Short-term	2	9	37	2858	05/05/16 03:20	46	effects	neutral
718704054	Intermediate-term	2	10	36	1529	05/05/16 03:20	46	effects	neutral
718704054	Long-term	2	11	35	12079	05/05/16 03:20	46	effects	neutral
718704054	During pregnancy	2	12	34	1452	05/05/16 03:20	46	effects	negative
720907051	Effects	1	6	39	1227	18/05/16 17:42	45	effects	neutral
720907051	Overdose	2	13	32	4990	18/05/16 17:42	45	effects	negative
720907051	Adverse effects	1	7	38	21	18/05/16 17:42	45	effects	negative
720907051	Medical	2	2	43	816	18/05/16 17:42	45	uses	positive
720907051	Reinforcement disorders	2	12	33	2377	18/05/16 17:42	45	effects	neutral
720907051	Alternative medicine	2	3	42	532	18/05/16 17:42	45	uses	positive
720907051	Short-term	2	8	37	2858	18/05/16 17:42	45	effects	neutral
720907051	Intermediate-term	2	9	36	2368	18/05/16 17:42	45	effects	neutral
720907051	Long-term	2	10	35	12078	18/05/16 17:42	45	effects	neutral
720907051	During pregnancy	2	11	34	1452	18/05/16 17:42	45	effects	negative
720907105	Effects	1	6	40	1227	18/05/16 17:43	46	effects	neutral
720907105	Overdose	2	14	32	4990	18/05/16 17:43	46	effects	negative
720907105	Harm assessment	2	13	33	2560	18/05/16 17:43	46	safety	negative
720907105	Adverse effects	1	7	39	21	18/05/16 17:43	46	effects	negative
720907105	Medical	2	2	44	816	18/05/16 17:43	46	uses	positive
720907105	Reinforcement disorders	2	12	34	2377	18/05/16 17:43	46	effects	neutral
720907105	Alternative medicine	2	3	43	532	18/05/16 17:43	46	uses	positive
720907105	Short-term	2	8	38	2858	18/05/16 17:43	46	effects	neutral
720907105	Intermediate-term	2	9	37	2368	18/05/16 17:43	46	effects	neutral
720907105	Long-term	2	10	36	12078	18/05/16 17:43	46	effects	neutral
720907105	During pregnancy	2	11	35	1452	18/05/16 17:43	46	effects	negative